"BA Code","Timestamp (Hour Ending)","Demand (MWh)","Demand Forecast (MWh)","Net Generation (MWh)","Total Interchange (MWh)"
PSCO,"4/1/2023 12 a.m. MDT",4404,4408,4875,471
PSCO,"4/1/2023 1 a.m. MDT",4264,4077,4626,362
PSCO,"4/1/2023 2 a.m. MDT",4200,3950,4476,276
PSCO,"4/1/2023 3 a.m. MDT",4139,3938,4451,312
PSCO,"4/1/2023 4 a.m. MDT",4132,3978,4312,180
PSCO,"4/1/2023 5 a.m. MDT",4184,4068,4238,54
PSCO,"4/1/2023 6 a.m. MDT",4322,4254,4200,-122
PSCO,"4/1/2023 7 a.m. MDT",4442,4401,4526,84
PSCO,"4/1/2023 8 a.m. MDT",4502,4443,4817,315
PSCO,"4/1/2023 9 a.m. MDT",4390,4409,4691,301
PSCO,"4/1/2023 10 a.m. MDT",4260,4172,4616,356
PSCO,"4/1/2023 11 a.m. MDT",4083,4014,4477,394
PSCO,"4/1/2023 12 p.m. MDT",3931,3888,4232,301
PSCO,"4/1/2023 1 p.m. MDT",3837,3738,3745,-92
PSCO,"4/1/2023 2 p.m. MDT",3771,3679,3653,-118
PSCO,"4/1/2023 3 p.m. MDT",3743,3715,3837,94
PSCO,"4/1/2023 4 p.m. MDT",3820,3814,3992,172
PSCO,"4/1/2023 5 p.m. MDT",3970,3925,4249,279
PSCO,"4/1/2023 6 p.m. MDT",4223,4148,4518,295
PSCO,"4/1/2023 7 p.m. MDT",4465,4374,4821,356
PSCO,"4/1/2023 8 p.m. MDT",4626,4499,4924,298
PSCO,"4/1/2023 9 p.m. MDT",4661,4554,4638,-23
PSCO,"4/1/2023 10 p.m. MDT",4471,4387,4448,-23
PSCO,"4/1/2023 11 p.m. MDT",4277,4195,4396,119
PSCO,"4/2/2023 12 a.m. MDT",4130,4052,4382,252
PSCO,"4/2/2023 1 a.m. MDT",3980,4080,4534,554
PSCO,"4/2/2023 2 a.m. MDT",3890,3982,4667,777
PSCO,"4/2/2023 3 a.m. MDT",3854,3919,4634,780
PSCO,"4/2/2023 4 a.m. MDT",3798,3909,4510,712
PSCO,"4/2/2023 5 a.m. MDT",3879,3952,4429,550
PSCO,"4/2/2023 6 a.m. MDT",3962,4055,4309,347
PSCO,"4/2/2023 7 a.m. MDT",4052,4254,4434,382
PSCO,"4/2/2023 8 a.m. MDT",4071,4310,4241,170
PSCO,"4/2/2023 9 a.m. MDT",3976,4207,4081,105
PSCO,"4/2/2023 10 a.m. MDT",3898,4051,3968,70
PSCO,"4/2/2023 11 a.m. MDT",3785,3960,3797,12
PSCO,"4/2/2023 12 p.m. MDT",3745,3859,3666,-79
PSCO,"4/2/2023 1 p.m. MDT",3719,3831,3785,66
PSCO,"4/2/2023 2 p.m. MDT",3693,3822,3881,188
PSCO,"4/2/2023 3 p.m. MDT",3718,3791,3894,176
PSCO,"4/2/2023 4 p.m. MDT",3821,3917,4133,312
PSCO,"4/2/2023 5 p.m. MDT",4043,4099,4251,208
PSCO,"4/2/2023 6 p.m. MDT",4311,4344,4408,97
PSCO,"4/2/2023 7 p.m. MDT",4559,4627,4758,199
PSCO,"4/2/2023 8 p.m. MDT",4722,4823,4889,167
PSCO,"4/2/2023 9 p.m. MDT",4740,4814,5129,389
PSCO,"4/2/2023 10 p.m. MDT",4493,4662,4932,439
PSCO,"4/2/2023 11 p.m. MDT",4185,4371,4686,501
PSCO,"4/3/2023 12 a.m. MDT",3943,4087,4363,420
PSCO,"4/3/2023 1 a.m. MDT",3829,3928,4319,490
PSCO,"4/3/2023 2 a.m. MDT",3768,3959,4499,731
PSCO,"4/3/2023 3 a.m. MDT",3709,3791,4150,441
PSCO,"4/3/2023 4 a.m. MDT",3697,3773,4063,366
PSCO,"4/3/2023 5 a.m. MDT",3883,4046,4116,233
PSCO,"4/3/2023 6 a.m. MDT",4207,4411,4387,180
PSCO,"4/3/2023 7 a.m. MDT",4583,4765,4792,209
PSCO,"4/3/2023 8 a.m. MDT",4720,4921,4979,259
PSCO,"4/3/2023 9 a.m. MDT",4654,4736,5086,432
PSCO,"4/3/2023 10 a.m. MDT",4481,4433,5012,531
PSCO,"4/3/2023 11 a.m. MDT",4386,4311,5163,777
PSCO,"4/3/2023 12 p.m. MDT",4304,4210,5216,912
PSCO,"4/3/2023 1 p.m. MDT",4275,4121,5046,771
PSCO,"4/3/2023 2 p.m. MDT",4208,4040,4964,756
PSCO,"4/3/2023 3 p.m. MDT",4214,4013,4965,751
PSCO,"4/3/2023 4 p.m. MDT",4302,4108,5115,813
PSCO,"4/3/2023 5 p.m. MDT",4377,4235,5078,701
PSCO,"4/3/2023 6 p.m. MDT",4597,4394,5129,532
PSCO,"4/3/2023 7 p.m. MDT",4745,4506,4932,187
PSCO,"4/3/2023 8 p.m. MDT",4946,4673,5380,434
PSCO,"4/3/2023 9 p.m. MDT",4920,4863,5380,460
PSCO,"4/3/2023 10 p.m. MDT",4728,4703,5273,545
PSCO,"4/3/2023 11 p.m. MDT",4440,4447,5149,709
PSCO,"4/4/2023 12 a.m. MDT",4206,4220,4988,782
PSCO,"4/4/2023 1 a.m. MDT",4064,4243,4826,762
PSCO,"4/4/2023 2 a.m. MDT",4026,4041,4742,716
PSCO,"4/4/2023 3 a.m. MDT",4018,4137,4543,525
PSCO,"4/4/2023 4 a.m. MDT",4086,4069,4399,313
PSCO,"4/4/2023 5 a.m. MDT",4197,4193,4587,390
PSCO,"4/4/2023 6 a.m. MDT",4444,4491,4971,527
PSCO,"4/4/2023 7 a.m. MDT",4910,4936,5446,536
PSCO,"4/4/2023 8 a.m. MDT",5202,5101,5501,299
PSCO,"4/4/2023 9 a.m. MDT",5318,5051,5721,403
PSCO,"4/4/2023 10 a.m. MDT",5374,5041,5789,415
PSCO,"4/4/2023 11 a.m. MDT",5359,5057,5582,223
PSCO,"4/4/2023 12 p.m. MDT",5259,5011,5378,119
PSCO,"4/4/2023 1 p.m. MDT",5195,4987,5385,190
PSCO,"4/4/2023 2 p.m. MDT",5142,4950,5330,188
PSCO,"4/4/2023 3 p.m. MDT",5170,4927,5588,418
PSCO,"4/4/2023 4 p.m. MDT",5225,5007,5679,454
PSCO,"4/4/2023 5 p.m. MDT",5293,5184,5875,582
PSCO,"4/4/2023 6 p.m. MDT",5430,5249,6045,615
PSCO,"4/4/2023 7 p.m. MDT",5471,5300,6025,554
PSCO,"4/4/2023 8 p.m. MDT",5569,5369,6190,621
PSCO,"4/4/2023 9 p.m. MDT",5556,5393,6217,661
PSCO,"4/4/2023 10 p.m. MDT",5360,5277,6026,666
PSCO,"4/4/2023 11 p.m. MDT",5025,4966,5716,691
PSCO,"4/5/2023 12 a.m. MDT",4802,4720,5654,852
PSCO,"4/5/2023 1 a.m. MDT",4637,4834,5532,895
PSCO,"4/5/2023 2 a.m. MDT",4578,4684,5555,977
PSCO,"4/5/2023 3 a.m. MDT",4551,4597,5457,906
PSCO,"4/5/2023 4 a.m. MDT",4596,4676,5448,852
PSCO,"4/5/2023 5 a.m. MDT",4757,4797,5577,820
PSCO,"4/5/2023 6 a.m. MDT",4999,5006,5647,648
PSCO,"4/5/2023 7 a.m. MDT",5379,5330,5850,471
PSCO,"4/5/2023 8 a.m. MDT",5529,5414,6131,602
PSCO,"4/5/2023 9 a.m. MDT",5402,5221,5985,583
PSCO,"4/5/2023 10 a.m. MDT",5239,5020,5494,255
PSCO,"4/5/2023 11 a.m. MDT",5017,4865,5220,203
PSCO,"4/5/2023 12 p.m. MDT",4844,4795,4891,47
PSCO,"4/5/2023 1 p.m. MDT",4700,4706,4677,-23
PSCO,"4/5/2023 2 p.m. MDT",4635,4694,4698,63
PSCO,"4/5/2023 3 p.m. MDT",4656,4811,4588,-68
PSCO,"4/5/2023 4 p.m. MDT",4734,4905,4741,7
PSCO,"4/5/2023 5 p.m. MDT",4895,5005,4894,-1
PSCO,"4/5/2023 6 p.m. MDT",5137,5153,5193,56
PSCO,"4/5/2023 7 p.m. MDT",5241,5264,5409,168
PSCO,"4/5/2023 8 p.m. MDT",5393,5318,5576,183
PSCO,"4/5/2023 9 p.m. MDT",5397,5348,5679,282
PSCO,"4/5/2023 10 p.m. MDT",5184,5140,5705,521
PSCO,"4/5/2023 11 p.m. MDT",4876,4801,5328,452
PSCO,"4/6/2023 12 a.m. MDT",4613,4595,5088,475
PSCO,"4/6/2023 1 a.m. MDT",4467,4419,4918,451
PSCO,"4/6/2023 2 a.m. MDT",4393,4427,4917,524
PSCO,"4/6/2023 3 a.m. MDT",4401,4455,4982,581
PSCO,"4/6/2023 4 a.m. MDT",4407,4511,4966,559
PSCO,"4/6/2023 5 a.m. MDT",4559,4639,4938,379
PSCO,"4/6/2023 6 a.m. MDT",4828,4878,5062,234
PSCO,"4/6/2023 7 a.m. MDT",5222,5241,5455,233
PSCO,"4/6/2023 8 a.m. MDT",5363,5340,5702,339
PSCO,"4/6/2023 9 a.m. MDT",5107,5117,5471,364
PSCO,"4/6/2023 10 a.m. MDT",4858,4781,5083,225
PSCO,"4/6/2023 11 a.m. MDT",4660,4640,4873,213
PSCO,"4/6/2023 12 p.m. MDT",4466,4514,4644,178
PSCO,"4/6/2023 1 p.m. MDT",4347,4410,4507,160
PSCO,"4/6/2023 2 p.m. MDT",4248,4323,4385,137
PSCO,"4/6/2023 3 p.m. MDT",4252,4293,4392,140
PSCO,"4/6/2023 4 p.m. MDT",4191,4390,4377,186
PSCO,"4/6/2023 5 p.m. MDT",4283,4525,4462,179
PSCO,"4/6/2023 6 p.m. MDT",4433,4697,4667,234
PSCO,"4/6/2023 7 p.m. MDT",4658,4821,4983,325
PSCO,"4/6/2023 8 p.m. MDT",4937,5007,5555,618
PSCO,"4/6/2023 9 p.m. MDT",5018,4970,5706,688
PSCO,"4/6/2023 10 p.m. MDT",4841,4861,5588,747
PSCO,"4/6/2023 11 p.m. MDT",4635,4602,5234,599
PSCO,"4/7/2023 12 a.m. MDT",4416,4405,5075,659
PSCO,"4/7/2023 1 a.m. MDT",4290,4332,4963,673
PSCO,"4/7/2023 2 a.m. MDT",4176,4353,4818,642
PSCO,"4/7/2023 3 a.m. MDT",4171,4390,4755,584
PSCO,"4/7/2023 4 a.m. MDT",4219,4389,4731,512
PSCO,"4/7/2023 5 a.m. MDT",4355,4577,4841,486
PSCO,"4/7/2023 6 a.m. MDT",4565,4781,5064,499
PSCO,"4/7/2023 7 a.m. MDT",4917,5053,5182,265
PSCO,"4/7/2023 8 a.m. MDT",5037,5072,5273,236
PSCO,"4/7/2023 9 a.m. MDT",4873,4820,5085,212
PSCO,"4/7/2023 10 a.m. MDT",4565,4584,4592,27
PSCO,"4/7/2023 11 a.m. MDT",4424,4365,4445,21
PSCO,"4/7/2023 12 p.m. MDT",4261,4215,4400,139
PSCO,"4/7/2023 1 p.m. MDT",4146,4105,4382,236
PSCO,"4/7/2023 2 p.m. MDT",4117,4089,4511,394
PSCO,"4/7/2023 3 p.m. MDT",4132,4133,4428,296
PSCO,"4/7/2023 4 p.m. MDT",4179,4226,4389,210
PSCO,"4/7/2023 5 p.m. MDT",4290,4419,4341,51
PSCO,"4/7/2023 6 p.m. MDT",4391,4546,4178,-213
PSCO,"4/7/2023 7 p.m. MDT",4504,4645,4271,-233
PSCO,"4/7/2023 8 p.m. MDT",4636,4738,4584,-52
PSCO,"4/7/2023 9 p.m. MDT",4673,4763,4755,82
PSCO,"4/7/2023 10 p.m. MDT",4520,4576,4676,156
PSCO,"4/7/2023 11 p.m. MDT",4312,4376,4461,149
PSCO,"4/8/2023 12 a.m. MDT",4089,4205,4243,154
PSCO,"4/8/2023 1 a.m. MDT",3924,3938,4047,123
PSCO,"4/8/2023 2 a.m. MDT",3829,3813,3881,52
PSCO,"4/8/2023 3 a.m. MDT",3844,3748,3907,63
PSCO,"4/8/2023 4 a.m. MDT",3874,3794,4030,156
PSCO,"4/8/2023 5 a.m. MDT",3908,3816,4261,353
PSCO,"4/8/2023 6 a.m. MDT",4041,3940,4391,350
PSCO,"4/8/2023 7 a.m. MDT",4188,4097,4383,195
PSCO,"4/8/2023 8 a.m. MDT",4246,4111,4398,152
PSCO,"4/8/2023 9 a.m. MDT",4264,4153,4343,79
PSCO,"4/8/2023 10 a.m. MDT",4239,4104,4256,17
PSCO,"4/8/2023 11 a.m. MDT",4238,4019,4042,-196
PSCO,"4/8/2023 12 p.m. MDT",4261,3917,4006,-255
PSCO,"4/8/2023 1 p.m. MDT",4107,3906,3843,-264
PSCO,"4/8/2023 2 p.m. MDT",4150,3937,3970,-180
PSCO,"4/8/2023 3 p.m. MDT",4197,3976,4046,-151
PSCO,"4/8/2023 4 p.m. MDT",4372,4057,4284,-88
PSCO,"4/8/2023 5 p.m. MDT",4403,4216,4343,-60
PSCO,"4/8/2023 6 p.m. MDT",4539,4292,4286,-253
PSCO,"4/8/2023 7 p.m. MDT",4628,4415,4437,-191
PSCO,"4/8/2023 8 p.m. MDT",4589,4483,4558,-31
PSCO,"4/8/2023 9 p.m. MDT",4575,4503,4672,97
PSCO,"4/8/2023 10 p.m. MDT",4451,4407,4593,142
PSCO,"4/8/2023 11 p.m. MDT",4227,4238,4524,297
PSCO,"4/9/2023 12 a.m. MDT",3974,4008,4373,399
PSCO,"4/9/2023 1 a.m. MDT",3896,3908,4554,658
PSCO,"4/9/2023 2 a.m. MDT",3802,3788,4266,464
PSCO,"4/9/2023 3 a.m. MDT",3755,3695,4143,388
PSCO,"4/9/2023 4 a.m. MDT",3756,3682,4155,399
PSCO,"4/9/2023 5 a.m. MDT",3809,3713,4093,284
PSCO,"4/9/2023 6 a.m. MDT",3877,3787,4119,242
PSCO,"4/9/2023 7 a.m. MDT",3989,3931,4200,211
PSCO,"4/9/2023 8 a.m. MDT",3992,3975,4225,233
PSCO,"4/9/2023 9 a.m. MDT",3935,3979,4220,285
PSCO,"4/9/2023 10 a.m. MDT",3900,3985,4127,227
PSCO,"4/9/2023 11 a.m. MDT",3811,3978,3941,130
PSCO,"4/9/2023 12 p.m. MDT",3753,3907,3731,-22
PSCO,"4/9/2023 1 p.m. MDT",3719,3867,3597,-122
PSCO,"4/9/2023 2 p.m. MDT",3666,3703,3549,-117
PSCO,"4/9/2023 3 p.m. MDT",3587,3679,3596,9
PSCO,"4/9/2023 4 p.m. MDT",3706,3764,3816,110
PSCO,"4/9/2023 5 p.m. MDT",3832,3858,3930,98
PSCO,"4/9/2023 6 p.m. MDT",4029,4099,3918,-111
PSCO,"4/9/2023 7 p.m. MDT",4293,4288,4247,-46
PSCO,"4/9/2023 8 p.m. MDT",4523,4692,4645,122
PSCO,"4/9/2023 9 p.m. MDT",4578,4792,4802,224
PSCO,"4/9/2023 10 p.m. MDT",4377,4629,4611,234
PSCO,"4/9/2023 11 p.m. MDT",4146,4352,4381,235
PSCO,"4/10/2023 12 a.m. MDT",3880,4008,4084,204
PSCO,"4/10/2023 1 a.m. MDT",3722,3735,3932,210
PSCO,"4/10/2023 2 a.m. MDT",3648,3758,3839,191
PSCO,"4/10/2023 3 a.m. MDT",3651,3702,3909,258
PSCO,"4/10/2023 4 a.m. MDT",3682,3790,3912,230
PSCO,"4/10/2023 5 a.m. MDT",3804,3911,3950,146
PSCO,"4/10/2023 6 a.m. MDT",4075,4209,4318,243
PSCO,"4/10/2023 7 a.m. MDT",4461,4564,4650,189
PSCO,"4/10/2023 8 a.m. MDT",4541,4722,4850,309
PSCO,"4/10/2023 9 a.m. MDT",4426,4544,4626,200
PSCO,"4/10/2023 10 a.m. MDT",4326,4420,4544,218
PSCO,"4/10/2023 11 a.m. MDT",4244,4311,4420,176
PSCO,"4/10/2023 12 p.m. MDT",4206,4367,4249,43
PSCO,"4/10/2023 1 p.m. MDT",4188,4408,4266,78
PSCO,"4/10/2023 2 p.m. MDT",4188,4455,4329,141
PSCO,"4/10/2023 3 p.m. MDT",4175,4535,4443,268
PSCO,"4/10/2023 4 p.m. MDT",4261,4569,4586,325
PSCO,"4/10/2023 5 p.m. MDT",4421,4708,4693,272
PSCO,"4/10/2023 6 p.m. MDT",4615,4812,4759,144
PSCO,"4/10/2023 7 p.m. MDT",4782,4917,4964,182
PSCO,"4/10/2023 8 p.m. MDT",4922,4905,5208,286
PSCO,"4/10/2023 9 p.m. MDT",4930,4950,5376,446
PSCO,"4/10/2023 10 p.m. MDT",4620,4815,5097,477
PSCO,"4/10/2023 11 p.m. MDT",4276,4501,4871,595
PSCO,"4/11/2023 12 a.m. MDT",4000,4197,4784,784
PSCO,"4/11/2023 1 a.m. MDT",3771,3928,4442,671
PSCO,"4/11/2023 2 a.m. MDT",3679,3830,4318,639
PSCO,"4/11/2023 3 a.m. MDT",3661,3767,4336,675
PSCO,"4/11/2023 4 a.m. MDT",3678,3814,4416,738
PSCO,"4/11/2023 5 a.m. MDT",3775,3895,4532,757
PSCO,"4/11/2023 6 a.m. MDT",4047,4110,4895,848
PSCO,"4/11/2023 7 a.m. MDT",4440,4473,5224,784
PSCO,"4/11/2023 8 a.m. MDT",4532,4629,5346,814
PSCO,"4/11/2023 9 a.m. MDT",4400,4533,4933,533
PSCO,"4/11/2023 10 a.m. MDT",4482,4469,4779,297
PSCO,"4/11/2023 11 a.m. MDT",4519,4428,4812,293
PSCO,"4/11/2023 12 p.m. MDT",4529,4525,4948,419
PSCO,"4/11/2023 1 p.m. MDT",4600,4593,4929,329
PSCO,"4/11/2023 2 p.m. MDT",4647,4653,4906,259
PSCO,"4/11/2023 3 p.m. MDT",4756,4775,4898,142
PSCO,"4/11/2023 4 p.m. MDT",4841,4932,4952,111
PSCO,"4/11/2023 5 p.m. MDT",4943,5143,5317,374
PSCO,"4/11/2023 6 p.m. MDT",5102,5237,5493,391
PSCO,"4/11/2023 7 p.m. MDT",5334,5258,5628,294
PSCO,"4/11/2023 8 p.m. MDT",5309,5242,5531,222
PSCO,"4/11/2023 9 p.m. MDT",5217,5124,5548,331
PSCO,"4/11/2023 10 p.m. MDT",4878,4906,5350,472
PSCO,"4/11/2023 11 p.m. MDT",4546,4516,5056,510
PSCO,"4/12/2023 12 a.m. MDT",4191,4269,4746,555
PSCO,"4/12/2023 1 a.m. MDT",3954,4089,4434,480
PSCO,"4/12/2023 2 a.m. MDT",3790,3944,4225,435
PSCO,"4/12/2023 3 a.m. MDT",3717,3891,4078,361
PSCO,"4/12/2023 4 a.m. MDT",3694,3892,4064,370
PSCO,"4/12/2023 5 a.m. MDT",3785,3958,4169,384
PSCO,"4/12/2023 6 a.m. MDT",3988,4186,4316,328
PSCO,"4/12/2023 7 a.m. MDT",4322,4483,4340,18
PSCO,"4/12/2023 8 a.m. MDT",4382,4615,4331,-51
PSCO,"4/12/2023 9 a.m. MDT",4356,4584,4240,-116
PSCO,"4/12/2023 10 a.m. MDT",4385,4501,4186,-199
PSCO,"4/12/2023 11 a.m. MDT",4396,4570,4245,-151
PSCO,"4/12/2023 12 p.m. MDT",4531,4615,4568,37
PSCO,"4/12/2023 1 p.m. MDT",4689,4636,5035,346
PSCO,"4/12/2023 2 p.m. MDT",4850,4803,5395,545
PSCO,"4/12/2023 3 p.m. MDT",4943,4897,5651,708
PSCO,"4/12/2023 4 p.m. MDT",5061,5259,5744,683
PSCO,"4/12/2023 5 p.m. MDT",5193,5537,5808,615
PSCO,"4/12/2023 6 p.m. MDT",5308,5455,5855,547
PSCO,"4/12/2023 7 p.m. MDT",5336,5452,5667,331
PSCO,"4/12/2023 8 p.m. MDT",5321,5502,5704,383
PSCO,"4/12/2023 9 p.m. MDT",5212,5416,5769,557
PSCO,"4/12/2023 10 p.m. MDT",4951,5105,5636,685
PSCO,"4/12/2023 11 p.m. MDT",4580,4667,5072,492
PSCO,"4/13/2023 12 a.m. MDT",4261,4359,4518,257
PSCO,"4/13/2023 1 a.m. MDT",4018,4049,4249,231
PSCO,"4/13/2023 2 a.m. MDT",3839,3803,4026,187
PSCO,"4/13/2023 3 a.m. MDT",3799,3879,4078,279
PSCO,"4/13/2023 4 a.m. MDT",3740,3861,4136,396
PSCO,"4/13/2023 5 a.m. MDT",3830,3913,4357,527
PSCO,"4/13/2023 6 a.m. MDT",3969,4321,4329,360
PSCO,"4/13/2023 7 a.m. MDT",4315,4623,4630,315
PSCO,"4/13/2023 8 a.m. MDT",4530,4726,4773,243
PSCO,"4/13/2023 9 a.m. MDT",4609,4719,4727,118
PSCO,"4/13/2023 10 a.m. MDT",4672,4726,4935,263
PSCO,"4/13/2023 11 a.m. MDT",4558,4779,4932,374
PSCO,"4/13/2023 12 p.m. MDT",4477,4845,5010,533
PSCO,"4/13/2023 1 p.m. MDT",4613,4946,5117,504
PSCO,"4/13/2023 2 p.m. MDT",4679,5085,5161,482
PSCO,"4/13/2023 3 p.m. MDT",4688,5180,5044,356
PSCO,"4/13/2023 4 p.m. MDT",4806,5259,5042,236
PSCO,"4/13/2023 5 p.m. MDT",4926,5290,5193,267
PSCO,"4/13/2023 6 p.m. MDT",4978,5280,5093,115
PSCO,"4/13/2023 7 p.m. MDT",4921,5279,5039,118
PSCO,"4/13/2023 8 p.m. MDT",4954,5248,5148,194
PSCO,"4/13/2023 9 p.m. MDT",4958,5136,5196,238
PSCO,"4/13/2023 10 p.m. MDT",4730,4927,4971,241
PSCO,"4/13/2023 11 p.m. MDT",4401,4479,4732,331
PSCO,"4/14/2023 12 a.m. MDT",4088,4169,4596,508
PSCO,"4/14/2023 1 a.m. MDT",3915,3949,4344,429
PSCO,"4/14/2023 2 a.m. MDT",3757,3768,4222,465
PSCO,"4/14/2023 3 a.m. MDT",3692,3621,4282,590
PSCO,"4/14/2023 4 a.m. MDT",3683,3610,4295,612
PSCO,"4/14/2023 5 a.m. MDT",3746,3852,4423,677
PSCO,"4/14/2023 6 a.m. MDT",3935,4109,4684,749
PSCO,"4/14/2023 7 a.m. MDT",4318,4461,4795,477
PSCO,"4/14/2023 8 a.m. MDT",4634,4613,5078,444
PSCO,"4/14/2023 9 a.m. MDT",4792,4681,5212,420
PSCO,"4/14/2023 10 a.m. MDT",4871,4708,5169,298
PSCO,"4/14/2023 11 a.m. MDT",4944,4717,5029,85
PSCO,"4/14/2023 12 p.m. MDT",4979,4703,5093,114
PSCO,"4/14/2023 1 p.m. MDT",4929,4691,5097,168
PSCO,"4/14/2023 2 p.m. MDT",4953,4645,5167,214
PSCO,"4/14/2023 3 p.m. MDT",4917,4628,5072,155
PSCO,"4/14/2023 4 p.m. MDT",4899,4715,5157,258
PSCO,"4/14/2023 5 p.m. MDT",4963,4846,5383,420
PSCO,"4/14/2023 6 p.m. MDT",4955,5046,5453,498
PSCO,"4/14/2023 7 p.m. MDT",4965,4922,5258,293
PSCO,"4/14/2023 8 p.m. MDT",5025,5007,5373,348
PSCO,"4/14/2023 9 p.m. MDT",4981,4990,5181,200
PSCO,"4/14/2023 10 p.m. MDT",4822,4813,5019,197
PSCO,"4/14/2023 11 p.m. MDT",4572,4571,4715,143
PSCO,"4/15/2023 12 a.m. MDT",4325,4334,4513,188
PSCO,"4/15/2023 1 a.m. MDT",4180,4080,4456,276
PSCO,"4/15/2023 2 a.m. MDT",4036,3917,4140,104
PSCO,"4/15/2023 3 a.m. MDT",4007,3865,4027,20
PSCO,"4/15/2023 4 a.m. MDT",3993,3843,4118,125
PSCO,"4/15/2023 5 a.m. MDT",4015,3952,4080,65
PSCO,"4/15/2023 6 a.m. MDT",4115,4106,4322,207
PSCO,"4/15/2023 7 a.m. MDT",4295,4274,4355,60
PSCO,"4/15/2023 8 a.m. MDT",4345,4354,4394,49
PSCO,"4/15/2023 9 a.m. MDT",4245,4390,4158,-87
PSCO,"4/15/2023 10 a.m. MDT",4154,4354,4150,-4
PSCO,"4/15/2023 11 a.m. MDT",4038,4287,4118,80
PSCO,"4/15/2023 12 p.m. MDT",4007,4195,4063,56
PSCO,"4/15/2023 1 p.m. MDT",3932,4161,4004,72
PSCO,"4/15/2023 2 p.m. MDT",3924,4011,4001,77
PSCO,"4/15/2023 3 p.m. MDT",3955,3957,3973,18
PSCO,"4/15/2023 4 p.m. MDT",3871,3989,3863,-8
PSCO,"4/15/2023 5 p.m. MDT",3932,4102,3922,-10
PSCO,"4/15/2023 6 p.m. MDT",4102,4339,4045,-57
PSCO,"4/15/2023 7 p.m. MDT",4343,4510,4298,-45
PSCO,"4/15/2023 8 p.m. MDT",4580,4649,4557,-23
PSCO,"4/15/2023 9 p.m. MDT",4656,4715,4779,123
PSCO,"4/15/2023 10 p.m. MDT",4545,4594,4576,31
PSCO,"4/15/2023 11 p.m. MDT",4331,4405,4394,63
PSCO,"4/16/2023 12 a.m. MDT",4140,4228,4416,276
PSCO,"4/16/2023 1 a.m. MDT",3996,4197,4246,250
PSCO,"4/16/2023 2 a.m. MDT",3914,4129,4157,243
PSCO,"4/16/2023 3 a.m. MDT",3891,4064,4084,193
PSCO,"4/16/2023 4 a.m. MDT",3882,4079,4232,350
PSCO,"4/16/2023 5 a.m. MDT",3944,4125,4262,318
PSCO,"4/16/2023 6 a.m. MDT",4044,4270,4201,157
PSCO,"4/16/2023 7 a.m. MDT",4152,4308,4159,7
PSCO,"4/16/2023 8 a.m. MDT",4082,4313,4183,101
PSCO,"4/16/2023 9 a.m. MDT",3943,4247,4004,61
PSCO,"4/16/2023 10 a.m. MDT",3828,4119,3787,-41
PSCO,"4/16/2023 11 a.m. MDT",3740,4055,3645,-95
PSCO,"4/16/2023 12 p.m. MDT",3635,3991,3525,-110
PSCO,"4/16/2023 1 p.m. MDT",3598,3813,3520,-78
PSCO,"4/16/2023 2 p.m. MDT",3580,3716,3521,-59
PSCO,"4/16/2023 3 p.m. MDT",3577,3755,3507,-70
PSCO,"4/16/2023 4 p.m. MDT",3630,3784,3594,-36
PSCO,"4/16/2023 5 p.m. MDT",3863,4008,3886,23
PSCO,"4/16/2023 6 p.m. MDT",4117,4333,4124,7
PSCO,"4/16/2023 7 p.m. MDT",4341,4691,4450,109
PSCO,"4/16/2023 8 p.m. MDT",4528,4924,4851,323
PSCO,"4/16/2023 9 p.m. MDT",4612,4987,5130,518
PSCO,"4/16/2023 10 p.m. MDT",4446,4814,5007,561
PSCO,"4/16/2023 11 p.m. MDT",4167,4531,4640,473
PSCO,"4/17/2023 12 a.m. MDT",3909,4226,4420,511
PSCO,"4/17/2023 1 a.m. MDT",3759,3925,4452,693
PSCO,"4/17/2023 2 a.m. MDT",3663,3854,4456,793
PSCO,"4/17/2023 3 a.m. MDT",3668,3885,4441,773
PSCO,"4/17/2023 4 a.m. MDT",3671,3969,4150,479
PSCO,"4/17/2023 5 a.m. MDT",3824,4101,4009,185
PSCO,"4/17/2023 6 a.m. MDT",4090,4387,4155,65
PSCO,"4/17/2023 7 a.m. MDT",4428,4694,4451,23
PSCO,"4/17/2023 8 a.m. MDT",4474,4775,4519,45
PSCO,"4/17/2023 9 a.m. MDT",4367,4588,4354,-13
PSCO,"4/17/2023 10 a.m. MDT",4265,4454,4422,157
PSCO,"4/17/2023 11 a.m. MDT",4214,4405,4333,119
PSCO,"4/17/2023 12 p.m. MDT",4178,4367,4264,86
PSCO,"4/17/2023 1 p.m. MDT",4106,4246,4350,244
PSCO,"4/17/2023 2 p.m. MDT",4113,4309,4350,237
PSCO,"4/17/2023 3 p.m. MDT",4195,4335,4435,240
PSCO,"4/17/2023 4 p.m. MDT",4289,4421,4437,148
PSCO,"4/17/2023 5 p.m. MDT",4466,4603,4519,53
PSCO,"4/17/2023 6 p.m. MDT",4643,4891,4744,101
PSCO,"4/17/2023 7 p.m. MDT",4755,4976,4790,35
PSCO,"4/17/2023 8 p.m. MDT",4798,5013,4830,32
PSCO,"4/17/2023 9 p.m. MDT",4835,5154,5073,238
PSCO,"4/17/2023 10 p.m. MDT",4588,4894,5113,525
PSCO,"4/17/2023 11 p.m. MDT",4288,4533,4756,468
PSCO,"4/18/2023 12 a.m. MDT",4028,4204,4282,254
PSCO,"4/18/2023 1 a.m. MDT",3790,3959,4165,375
PSCO,"4/18/2023 2 a.m. MDT",3724,3861,3802,78
PSCO,"4/18/2023 3 a.m. MDT",3677,3864,3582,-95
PSCO,"4/18/2023 4 a.m. MDT",3655,3874,3788,133
PSCO,"4/18/2023 5 a.m. MDT",3778,3968,3802,24
PSCO,"4/18/2023 6 a.m. MDT",3967,4227,3881,-86
PSCO,"4/18/2023 7 a.m. MDT",4290,4529,4057,-233
PSCO,"4/18/2023 8 a.m. MDT",4495,4626,4244,-251
PSCO,"4/18/2023 9 a.m. MDT",4476,4608,4273,-203
PSCO,"4/18/2023 10 a.m. MDT",4321,4627,4311,-10
PSCO,"4/18/2023 11 a.m. MDT",4241,4524,4551,310
PSCO,"4/18/2023 12 p.m. MDT",4321,4521,4448,127
PSCO,"4/18/2023 1 p.m. MDT",4231,4536,4441,210
PSCO,"4/18/2023 2 p.m. MDT",4245,4637,4596,351
PSCO,"4/18/2023 3 p.m. MDT",4319,4666,4748,429
PSCO,"4/18/2023 4 p.m. MDT",4337,4822,4794,457
PSCO,"4/18/2023 5 p.m. MDT",4525,4957,5044,519
PSCO,"4/18/2023 6 p.m. MDT",4664,5054,5179,515
PSCO,"4/18/2023 7 p.m. MDT",4756,5108,4866,110
PSCO,"4/18/2023 8 p.m. MDT",4776,5141,4896,120
PSCO,"4/18/2023 9 p.m. MDT",4802,4999,4872,70
PSCO,"4/18/2023 10 p.m. MDT",4622,4827,4737,115
PSCO,"4/18/2023 11 p.m. MDT",4262,4484,4714,452
PSCO,"4/19/2023 12 a.m. MDT",3991,4223,4474,483
PSCO,"4/19/2023 1 a.m. MDT",3797,4007,4267,470
PSCO,"4/19/2023 2 a.m. MDT",3648,3914,4145,497
PSCO,"4/19/2023 3 a.m. MDT",3655,3893,4142,487
PSCO,"4/19/2023 4 a.m. MDT",3647,3933,4084,437
PSCO,"4/19/2023 5 a.m. MDT",3767,4000,4142,375
PSCO,"4/19/2023 6 a.m. MDT",4038,4249,4407,369
PSCO,"4/19/2023 7 a.m. MDT",4346,4589,4504,158
PSCO,"4/19/2023 8 a.m. MDT",4445,4720,4579,134
PSCO,"4/19/2023 9 a.m. MDT",4351,4661,4648,297
PSCO,"4/19/2023 10 a.m. MDT",4232,4505,4722,490
PSCO,"4/19/2023 11 a.m. MDT",4184,4453,4858,674
PSCO,"4/19/2023 12 p.m. MDT",4283,4422,5010,727
PSCO,"4/19/2023 1 p.m. MDT",4487,4488,4961,474
PSCO,"4/19/2023 2 p.m. MDT",4626,4534,5043,417
PSCO,"4/19/2023 3 p.m. MDT",4592,4558,5239,647
PSCO,"4/19/2023 4 p.m. MDT",4485,4647,5316,831
PSCO,"4/19/2023 5 p.m. MDT",4614,4715,5399,785
PSCO,"4/19/2023 6 p.m. MDT",4749,4843,5393,644
PSCO,"4/19/2023 7 p.m. MDT",4841,4934,5418,577
PSCO,"4/19/2023 8 p.m. MDT",4988,5016,5329,341
PSCO,"4/19/2023 9 p.m. MDT",5005,5109,5476,471
PSCO,"4/19/2023 10 p.m. MDT",4843,4971,5259,416
PSCO,"4/19/2023 11 p.m. MDT",4561,4663,4938,377
PSCO,"4/20/2023 12 a.m. MDT",4281,4419,4876,595
PSCO,"4/20/2023 1 a.m. MDT",4158,4266,4850,692
PSCO,"4/20/2023 2 a.m. MDT",4083,4146,4761,678
PSCO,"4/20/2023 3 a.m. MDT",4045,4136,4830,785
PSCO,"4/20/2023 4 a.m. MDT",4134,4100,4915,781
PSCO,"4/20/2023 5 a.m. MDT",4274,4249,5087,813
PSCO,"4/20/2023 6 a.m. MDT",4552,4528,5392,840
PSCO,"4/20/2023 7 a.m. MDT",4871,4892,5332,461
PSCO,"4/20/2023 8 a.m. MDT",4911,4976,5399,488
PSCO,"4/20/2023 9 a.m. MDT",4763,4872,5472,709
PSCO,"4/20/2023 10 a.m. MDT",4573,4620,5264,691
PSCO,"4/20/2023 11 a.m. MDT",4425,4509,4978,553
PSCO,"4/20/2023 12 p.m. MDT",4360,4456,5095,735
PSCO,"4/20/2023 1 p.m. MDT",4317,4369,4998,681
PSCO,"4/20/2023 2 p.m. MDT",4324,4399,4878,554
PSCO,"4/20/2023 3 p.m. MDT",4320,4430,4855,535
PSCO,"4/20/2023 4 p.m. MDT",4323,4508,4922,599
PSCO,"4/20/2023 5 p.m. MDT",4477,4594,4948,471
PSCO,"4/20/2023 6 p.m. MDT",4620,4742,5184,564
PSCO,"4/20/2023 7 p.m. MDT",4758,4873,5154,396
PSCO,"4/20/2023 8 p.m. MDT",4863,4995,5128,265
PSCO,"4/20/2023 9 p.m. MDT",5007,5094,4875,-132
PSCO,"4/20/2023 10 p.m. MDT",4843,4965,4972,129
PSCO,"4/20/2023 11 p.m. MDT",4583,4662,4711,128
PSCO,"4/21/2023 12 a.m. MDT",4275,4454,4543,268
PSCO,"4/21/2023 1 a.m. MDT",4131,4348,4335,204
PSCO,"4/21/2023 2 a.m. MDT",4061,4262,4285,224
PSCO,"4/21/2023 3 a.m. MDT",4038,4243,4212,174
PSCO,"4/21/2023 4 a.m. MDT",4076,4260,4286,210
PSCO,"4/21/2023 5 a.m. MDT",4210,4378,4336,126
PSCO,"4/21/2023 6 a.m. MDT",4450,4627,4550,100
PSCO,"4/21/2023 7 a.m. MDT",4792,4928,4881,89
PSCO,"4/21/2023 8 a.m. MDT",4851,4978,4851,0
PSCO,"4/21/2023 9 a.m. MDT",4948,4980,5020,72
PSCO,"4/21/2023 10 a.m. MDT",4886,4764,5004,118
PSCO,"4/21/2023 11 a.m. MDT",4682,4623,4865,183
PSCO,"4/21/2023 12 p.m. MDT",4592,4498,4771,179
PSCO,"4/21/2023 1 p.m. MDT",4535,4428,4639,104
PSCO,"4/21/2023 2 p.m. MDT",4467,4422,4615,148
PSCO,"4/21/2023 3 p.m. MDT",4489,4498,4603,114
PSCO,"4/21/2023 4 p.m. MDT",4518,4560,4507,-11
PSCO,"4/21/2023 5 p.m. MDT",4623,4648,4610,-13
PSCO,"4/21/2023 6 p.m. MDT",4715,4781,4813,98
PSCO,"4/21/2023 7 p.m. MDT",4766,4892,4983,217
PSCO,"4/21/2023 8 p.m. MDT",4875,4949,5112,237
PSCO,"4/21/2023 9 p.m. MDT",4892,4958,5017,125
PSCO,"4/21/2023 10 p.m. MDT",4741,4814,5017,276
PSCO,"4/21/2023 11 p.m. MDT",4532,4594,4783,251
PSCO,"4/22/2023 12 a.m. MDT",4327,4401,4652,325
PSCO,"4/22/2023 1 a.m. MDT",4180,4174,4731,551
PSCO,"4/22/2023 2 a.m. MDT",4049,4060,4627,578
PSCO,"4/22/2023 3 a.m. MDT",3990,4020,4312,322
PSCO,"4/22/2023 4 a.m. MDT",4001,4045,4319,318
PSCO,"4/22/2023 5 a.m. MDT",4126,4144,4335,209
PSCO,"4/22/2023 6 a.m. MDT",4232,4254,4400,168
PSCO,"4/22/2023 7 a.m. MDT",4339,4400,4290,-49
PSCO,"4/22/2023 8 a.m. MDT",4523,4419,4250,-273
PSCO,"4/22/2023 9 a.m. MDT",4695,4448,4301,-394
PSCO,"4/22/2023 10 a.m. MDT",4826,4478,4419,-407
PSCO,"4/22/2023 11 a.m. MDT",4836,4442,4493,-343
PSCO,"4/22/2023 12 p.m. MDT",4802,4360,4486,-316
PSCO,"4/22/2023 1 p.m. MDT",4686,4303,4377,-309
PSCO,"4/22/2023 2 p.m. MDT",4572,4272,4217,-355
PSCO,"4/22/2023 3 p.m. MDT",4466,4267,4127,-339
PSCO,"4/22/2023 4 p.m. MDT",4437,4266,4087,-350
PSCO,"4/22/2023 5 p.m. MDT",4480,4376,4195,-285
PSCO,"4/22/2023 6 p.m. MDT",4585,4456,4280,-305
PSCO,"4/22/2023 7 p.m. MDT",4665,4572,4282,-383
PSCO,"4/22/2023 8 p.m. MDT",4753,4697,4390,-363
PSCO,"4/22/2023 9 p.m. MDT",4824,4741,4531,-293
PSCO,"4/22/2023 10 p.m. MDT",4717,4632,4465,-252
PSCO,"4/22/2023 11 p.m. MDT",4562,4377,4386,-176
PSCO,"4/23/2023 12 a.m. MDT",4330,4224,4204,-126
PSCO,"4/23/2023 1 a.m. MDT",4190,4138,4069,-121
PSCO,"4/23/2023 2 a.m. MDT",4085,4046,3908,-177
PSCO,"4/23/2023 3 a.m. MDT",4048,4008,3902,-146
PSCO,"4/23/2023 4 a.m. MDT",4033,4051,3859,-174
PSCO,"4/23/2023 5 a.m. MDT",4098,4106,3962,-136
PSCO,"4/23/2023 6 a.m. MDT",4208,4213,4144,-64
PSCO,"4/23/2023 7 a.m. MDT",4285,4212,4377,92
PSCO,"4/23/2023 8 a.m. MDT",4249,4227,4320,71
PSCO,"4/23/2023 9 a.m. MDT",4168,4207,4189,21
PSCO,"4/23/2023 10 a.m. MDT",4107,4087,4088,-19
PSCO,"4/23/2023 11 a.m. MDT",3994,3984,3850,-144
PSCO,"4/23/2023 12 p.m. MDT",3874,3866,3709,-165
PSCO,"4/23/2023 1 p.m. MDT",3754,3730,3646,-108
PSCO,"4/23/2023 2 p.m. MDT",3691,3688,3649,-42
PSCO,"4/23/2023 3 p.m. MDT",3645,3737,3609,-36
PSCO,"4/23/2023 4 p.m. MDT",3721,3839,3689,-32
PSCO,"4/23/2023 5 p.m. MDT",3883,4091,3811,-72
PSCO,"4/23/2023 6 p.m. MDT",4130,4321,3989,-141
PSCO,"4/23/2023 7 p.m. MDT",4380,4579,4167,-213
PSCO,"4/23/2023 8 p.m. MDT",4538,4704,4349,-189
PSCO,"4/23/2023 9 p.m. MDT",4641,4813,4676,35
PSCO,"4/23/2023 10 p.m. MDT",4496,4538,4713,217
PSCO,"4/23/2023 11 p.m. MDT",4211,4283,4150,-61
PSCO,"4/24/2023 12 a.m. MDT",3969,4078,4019,50
PSCO,"4/24/2023 1 a.m. MDT",3801,3978,3792,-9
PSCO,"4/24/2023 2 a.m. MDT",3749,3928,3733,-16
PSCO,"4/24/2023 3 a.m. MDT",3744,3932,3864,120
PSCO,"4/24/2023 4 a.m. MDT",3788,3888,3952,164
PSCO,"4/24/2023 5 a.m. MDT",3916,4045,3954,38
PSCO,"4/24/2023 6 a.m. MDT",4208,4302,4171,-37
PSCO,"4/24/2023 7 a.m. MDT",4514,4649,4372,-142
PSCO,"4/24/2023 8 a.m. MDT",4667,4734,4485,-182
PSCO,"4/24/2023 9 a.m. MDT",4552,4716,4337,-215
PSCO,"4/24/2023 10 a.m. MDT",4368,4582,4091,-277
PSCO,"4/24/2023 11 a.m. MDT",4216,4521,4016,-200
PSCO,"4/24/2023 12 p.m. MDT",4098,4471,3942,-156
PSCO,"4/24/2023 1 p.m. MDT",4043,4444,3808,-235
PSCO,"4/24/2023 2 p.m. MDT",4036,4440,3947,-89
PSCO,"4/24/2023 3 p.m. MDT",4062,4478,4003,-59
PSCO,"4/24/2023 4 p.m. MDT",4194,4522,4247,53
PSCO,"4/24/2023 5 p.m. MDT",4308,4629,4254,-54
PSCO,"4/24/2023 6 p.m. MDT",4588,4742,4472,-116
PSCO,"4/24/2023 7 p.m. MDT",4680,4823,4615,-65
PSCO,"4/24/2023 8 p.m. MDT",4719,4879,4679,-40
PSCO,"4/24/2023 9 p.m. MDT",4778,4909,4962,184
PSCO,"4/24/2023 10 p.m. MDT",4552,4772,4838,286
PSCO,"4/24/2023 11 p.m. MDT",4289,4463,4439,150
PSCO,"4/25/2023 12 a.m. MDT",4047,4198,4244,197
PSCO,"4/25/2023 1 a.m. MDT",3851,4041,4138,287
PSCO,"4/25/2023 2 a.m. MDT",3754,3919,3925,171
PSCO,"4/25/2023 3 a.m. MDT",3727,3900,3909,182
PSCO,"4/25/2023 4 a.m. MDT",3707,3889,3564,-143
PSCO,"4/25/2023 5 a.m. MDT",3831,4027,3593,-238
PSCO,"4/25/2023 6 a.m. MDT",4081,4236,3914,-167
PSCO,"4/25/2023 7 a.m. MDT",4403,4647,4249,-154
PSCO,"4/25/2023 8 a.m. MDT",4514,4799,4327,-187
PSCO,"4/25/2023 9 a.m. MDT",4427,4830,4306,-121
PSCO,"4/25/2023 10 a.m. MDT",4335,4864,4254,-81
PSCO,"4/25/2023 11 a.m. MDT",4313,4864,4175,-138
PSCO,"4/25/2023 12 p.m. MDT",4283,4855,4276,-7
PSCO,"4/25/2023 1 p.m. MDT",4353,4853,4490,137
PSCO,"4/25/2023 2 p.m. MDT",4562,4807,4480,-82
PSCO,"4/25/2023 3 p.m. MDT",4725,4783,4722,-3
PSCO,"4/25/2023 4 p.m. MDT",4815,4767,4893,78
PSCO,"4/25/2023 5 p.m. MDT",4937,4863,4953,16
PSCO,"4/25/2023 6 p.m. MDT",5036,5036,4947,-89
PSCO,"4/25/2023 7 p.m. MDT",5045,5093,4928,-117
PSCO,"4/25/2023 8 p.m. MDT",5030,5087,5019,-11
PSCO,"4/25/2023 9 p.m. MDT",5021,5097,4900,-121
PSCO,"4/25/2023 10 p.m. MDT",4786,4914,4765,-21
PSCO,"4/25/2023 11 p.m. MDT",4485,4621,4735,250
PSCO,"4/26/2023 12 a.m. MDT",4228,4365,4299,71
PSCO,"4/26/2023 1 a.m. MDT",4093,4053,4094,1
PSCO,"4/26/2023 2 a.m. MDT",4002,3980,3885,-117
PSCO,"4/26/2023 3 a.m. MDT",3975,3933,3909,-66
PSCO,"4/26/2023 4 a.m. MDT",3979,3974,3938,-41
PSCO,"4/26/2023 5 a.m. MDT",4063,4098,3922,-141
PSCO,"4/26/2023 6 a.m. MDT",4320,4358,4146,-174
PSCO,"4/26/2023 7 a.m. MDT",4701,4719,4699,-2
PSCO,"4/26/2023 8 a.m. MDT",4924,4905,4938,14
PSCO,"4/26/2023 9 a.m. MDT",4907,4969,4821,-86
PSCO,"4/26/2023 10 a.m. MDT",4896,5006,4672,-224
PSCO,"4/26/2023 11 a.m. MDT",4748,5005,4549,-199
PSCO,"4/26/2023 12 p.m. MDT",4571,4992,4479,-92
PSCO,"4/26/2023 1 p.m. MDT",4417,4983,4341,-76
PSCO,"4/26/2023 2 p.m. MDT",4280,4853,4231,-49
PSCO,"4/26/2023 3 p.m. MDT",4207,4752,4129,-78
PSCO,"4/26/2023 4 p.m. MDT",4150,4678,4068,-82
PSCO,"4/26/2023 5 p.m. MDT",4183,4688,4007,-176
PSCO,"4/26/2023 6 p.m. MDT",4353,4717,4044,-309
PSCO,"4/26/2023 7 p.m. MDT",4529,4753,4167,-362
PSCO,"4/26/2023 8 p.m. MDT",4695,4802,4333,-362
PSCO,"4/26/2023 9 p.m. MDT",4799,4962,4603,-196
PSCO,"4/26/2023 10 p.m. MDT",4597,4800,4643,46
PSCO,"4/26/2023 11 p.m. MDT",4339,4515,4533,194
PSCO,"4/27/2023 12 a.m. MDT",4083,4273,4634,551
PSCO,"4/27/2023 1 a.m. MDT",3927,4026,4593,666
PSCO,"4/27/2023 2 a.m. MDT",3846,3955,4336,490
PSCO,"4/27/2023 3 a.m. MDT",3807,3913,3996,189
PSCO,"4/27/2023 4 a.m. MDT",3803,3971,3878,75
PSCO,"4/27/2023 5 a.m. MDT",3899,4071,3948,49
PSCO,"4/27/2023 6 a.m. MDT",4135,4305,4182,47
PSCO,"4/27/2023 7 a.m. MDT",4473,4560,4461,-12
PSCO,"4/27/2023 8 a.m. MDT",4536,4672,4621,85
PSCO,"4/27/2023 9 a.m. MDT",4356,4538,4797,441
PSCO,"4/27/2023 10 a.m. MDT",4228,4339,4937,709
PSCO,"4/27/2023 11 a.m. MDT",4151,4290,4863,712
PSCO,"4/27/2023 12 p.m. MDT",4128,4281,4910,782
PSCO,"4/27/2023 1 p.m. MDT",4129,4266,5074,945
PSCO,"4/27/2023 2 p.m. MDT",4231,4205,5177,946
PSCO,"4/27/2023 3 p.m. MDT",4336,4417,5173,837
PSCO,"4/27/2023 4 p.m. MDT",4421,4433,5090,669
PSCO,"4/27/2023 5 p.m. MDT",4457,4531,5279,822
PSCO,"4/27/2023 6 p.m. MDT",4633,4610,5633,1000
PSCO,"4/27/2023 7 p.m. MDT",4683,4678,5743,1060
PSCO,"4/27/2023 8 p.m. MDT",4803,4755,5908,1105
PSCO,"4/27/2023 9 p.m. MDT",4881,4843,6091,1210
PSCO,"4/27/2023 10 p.m. MDT",4708,4701,5844,1136
PSCO,"4/27/2023 11 p.m. MDT",4401,4438,5604,1203
PSCO,"4/28/2023 12 a.m. MDT",4160,4180,5318,1158
PSCO,"4/28/2023 1 a.m. MDT",4007,3984,5174,1167
PSCO,"4/28/2023 2 a.m. MDT",3944,3957,5100,1156
PSCO,"4/28/2023 3 a.m. MDT",3931,3923,5042,1111
PSCO,"4/28/2023 4 a.m. MDT",3957,3918,4953,996
PSCO,"4/28/2023 5 a.m. MDT",4042,4043,5114,1072
PSCO,"4/28/2023 6 a.m. MDT",4243,4273,5364,1121
PSCO,"4/28/2023 7 a.m. MDT",4492,4566,5549,1057
PSCO,"4/28/2023 8 a.m. MDT",4583,4747,5712,1129
PSCO,"4/28/2023 9 a.m. MDT",4487,4845,5302,815
PSCO,"4/28/2023 10 a.m. MDT",4363,4876,5223,860
PSCO,"4/28/2023 11 a.m. MDT",4370,4879,5218,848
PSCO,"4/28/2023 12 p.m. MDT",4237,4866,5122,885
PSCO,"4/28/2023 1 p.m. MDT",4158,4856,4975,817
PSCO,"4/28/2023 2 p.m. MDT",4093,4810,4893,800
PSCO,"4/28/2023 3 p.m. MDT",4006,4780,4887,881
PSCO,"4/28/2023 4 p.m. MDT",3984,4761,4835,851
PSCO,"4/28/2023 5 p.m. MDT",4085,4826,4823,738
PSCO,"4/28/2023 6 p.m. MDT",4225,4897,4948,723
PSCO,"4/28/2023 7 p.m. MDT",4387,4900,5194,807
PSCO,"4/28/2023 8 p.m. MDT",4531,4927,5306,775
PSCO,"4/28/2023 9 p.m. MDT",4646,4800,5112,466
PSCO,"4/28/2023 10 p.m. MDT",4551,4722,4660,109
PSCO,"4/28/2023 11 p.m. MDT",4327,4528,4346,19
PSCO,"4/29/2023 12 a.m. MDT",4073,4321,4165,92
PSCO,"4/29/2023 1 a.m. MDT",3914,4144,4164,250
PSCO,"4/29/2023 2 a.m. MDT",3832,4021,4193,361
PSCO,"4/29/2023 3 a.m. MDT",3791,4007,4225,434
PSCO,"4/29/2023 4 a.m. MDT",3750,4014,4302,552
PSCO,"4/29/2023 5 a.m. MDT",3846,4029,4280,434
PSCO,"4/29/2023 6 a.m. MDT",3944,4120,4379,435
PSCO,"4/29/2023 7 a.m. MDT",4045,4135,4591,546
PSCO,"4/29/2023 8 a.m. MDT",3990,4101,4661,671
PSCO,"4/29/2023 9 a.m. MDT",3887,4096,4539,652
PSCO,"4/29/2023 10 a.m. MDT",3797,4032,4714,917
PSCO,"4/29/2023 11 a.m. MDT",3789,4003,4445,656
PSCO,"4/29/2023 12 p.m. MDT",3728,3958,4440,712
PSCO,"4/29/2023 1 p.m. MDT",3701,3834,4346,645
PSCO,"4/29/2023 2 p.m. MDT",3717,3874,4383,666
PSCO,"4/29/2023 3 p.m. MDT",3802,3914,4455,653
PSCO,"4/29/2023 4 p.m. MDT",3887,4051,4484,597
PSCO,"4/29/2023 5 p.m. MDT",4075,4162,4746,671
PSCO,"4/29/2023 6 p.m. MDT",4295,4360,4886,591
PSCO,"4/29/2023 7 p.m. MDT",4422,4511,5080,658
PSCO,"4/29/2023 8 p.m. MDT",4464,4660,4617,153
PSCO,"4/29/2023 9 p.m. MDT",4547,4623,4624,77
PSCO,"4/29/2023 10 p.m. MDT",4355,4520,4474,119
PSCO,"4/29/2023 11 p.m. MDT",4126,4326,4214,88
PSCO,"4/30/2023 12 a.m. MDT",3856,4096,3772,-84
PSCO,"4/30/2023 1 a.m. MDT",3677,3904,3544,-133
PSCO,"4/30/2023 2 a.m. MDT",3563,3814,3412,-151
PSCO,"4/30/2023 3 a.m. MDT",3505,3752,3417,-88
PSCO,"4/30/2023 4 a.m. MDT",3472,3732,3505,33
PSCO,"4/30/2023 5 a.m. MDT",3555,3744,3571,16
PSCO,"4/30/2023 6 a.m. MDT",3609,3839,3565,-44
PSCO,"4/30/2023 7 a.m. MDT",3700,3864,3692,-8
PSCO,"4/30/2023 8 a.m. MDT",3621,3871,3748,127
PSCO,"4/30/2023 9 a.m. MDT",3586,3880,3715,129
PSCO,"4/30/2023 10 a.m. MDT",3565,3840,3692,127
PSCO,"4/30/2023 11 a.m. MDT",3547,3812,3621,74
PSCO,"4/30/2023 12 p.m. MDT",3591,3785,3550,-41
PSCO,"4/30/2023 1 p.m. MDT",3602,3695,3565,-37
PSCO,"4/30/2023 2 p.m. MDT",3622,3691,3621,-1
PSCO,"4/30/2023 3 p.m. MDT",3679,3749,3655,-24
PSCO,"4/30/2023 4 p.m. MDT",3806,3939,3750,-56
PSCO,"4/30/2023 5 p.m. MDT",4012,4128,4026,14
PSCO,"4/30/2023 6 p.m. MDT",4302,4228,4293,-9
PSCO,"4/30/2023 7 p.m. MDT",4505,4627,4410,-95
PSCO,"4/30/2023 8 p.m. MDT",4594,4674,4622,28
PSCO,"4/30/2023 9 p.m. MDT",4688,4750,4758,70
PSCO,"4/30/2023 10 p.m. MDT",4479,4539,4608,129
PSCO,"4/30/2023 11 p.m. MDT",4177,4363,4319,142
PSCO,"5/1/2023 12 a.m. MDT",3825,4028,3929,104
