"BA Code","Timestamp (Hour Ending)","Demand (MWh)","Demand Forecast (MWh)","Net Generation (MWh)","Total Interchange (MWh)"
PSCO,"8/1/2022 12 a.m. MDT",5109,5617,4852,-257
PSCO,"8/1/2022 1 a.m. MDT",4738,5420,4552,-186
PSCO,"8/1/2022 2 a.m. MDT",4620,5117,4304,-316
PSCO,"8/1/2022 3 a.m. MDT",4431,4913,4195,-236
PSCO,"8/1/2022 4 a.m. MDT",4343,4782,4131,-212
PSCO,"8/1/2022 5 a.m. MDT",4383,4765,4150,-233
PSCO,"8/1/2022 6 a.m. MDT",4500,4925,4377,-123
PSCO,"8/1/2022 7 a.m. MDT",4748,5119,4557,-191
PSCO,"8/1/2022 8 a.m. MDT",4865,5412,4683,-182
PSCO,"8/1/2022 9 a.m. MDT",5157,5720,4964,-193
PSCO,"8/1/2022 10 a.m. MDT",5480,6130,5191,-289
PSCO,"8/1/2022 11 a.m. MDT",5897,6576,5631,-266
PSCO,"8/1/2022 12 p.m. MDT",6274,7059,6135,-139
PSCO,"8/1/2022 1 p.m. MDT",6716,7559,6729,13
PSCO,"8/1/2022 2 p.m. MDT",7245,8018,7237,-8
PSCO,"8/1/2022 3 p.m. MDT",7619,8344,7470,-149
PSCO,"8/1/2022 4 p.m. MDT",8000,8677,7783,-217
PSCO,"8/1/2022 5 p.m. MDT",8010,8972,7965,-45
PSCO,"8/1/2022 6 p.m. MDT",7923,9067,7879,-44
PSCO,"8/1/2022 7 p.m. MDT",7606,8902,7596,-10
PSCO,"8/1/2022 8 p.m. MDT",7316,8599,7324,8
PSCO,"8/1/2022 9 p.m. MDT",7139,8247,6940,-199
PSCO,"8/1/2022 10 p.m. MDT",6714,7778,6413,-301
PSCO,"8/1/2022 11 p.m. MDT",6088,7033,5831,-257
PSCO,"8/2/2022 12 a.m. MDT",5408,6339,5188,-220
PSCO,"8/2/2022 1 a.m. MDT",5080,5113,4791,-289
PSCO,"8/2/2022 2 a.m. MDT",4807,4886,4683,-124
PSCO,"8/2/2022 3 a.m. MDT",4579,4629,4401,-178
PSCO,"8/2/2022 4 a.m. MDT",4428,4475,4334,-94
PSCO,"8/2/2022 5 a.m. MDT",4437,4465,4361,-76
PSCO,"8/2/2022 6 a.m. MDT",4641,4565,4607,-34
PSCO,"8/2/2022 7 a.m. MDT",4727,4748,4941,214
PSCO,"8/2/2022 8 a.m. MDT",5085,4989,5227,142
PSCO,"8/2/2022 9 a.m. MDT",5537,5250,5647,110
PSCO,"8/2/2022 10 a.m. MDT",5883,5686,6015,132
PSCO,"8/2/2022 11 a.m. MDT",6183,6115,6295,112
PSCO,"8/2/2022 12 p.m. MDT",6664,6656,6733,69
PSCO,"8/2/2022 1 p.m. MDT",7099,7128,7228,129
PSCO,"8/2/2022 2 p.m. MDT",7389,7545,7455,66
PSCO,"8/2/2022 3 p.m. MDT",7714,7739,7614,-100
PSCO,"8/2/2022 4 p.m. MDT",7913,7927,7708,-205
PSCO,"8/2/2022 5 p.m. MDT",8084,7985,7925,-159
PSCO,"8/2/2022 6 p.m. MDT",7941,7887,7796,-145
PSCO,"8/2/2022 7 p.m. MDT",7745,7648,7511,-234
PSCO,"8/2/2022 8 p.m. MDT",7247,7246,7161,-86
PSCO,"8/2/2022 9 p.m. MDT",6945,6995,6938,-7
PSCO,"8/2/2022 10 p.m. MDT",6729,6640,6519,-210
PSCO,"8/2/2022 11 p.m. MDT",6146,6013,6050,-96
PSCO,"8/3/2022 12 a.m. MDT",5522,5543,5580,58
PSCO,"8/3/2022 1 a.m. MDT",5207,5193,5322,115
PSCO,"8/3/2022 2 a.m. MDT",5063,4993,5199,136
PSCO,"8/3/2022 3 a.m. MDT",4867,4752,4942,75
PSCO,"8/3/2022 4 a.m. MDT",4741,4618,4771,30
PSCO,"8/3/2022 5 a.m. MDT",4732,4553,4869,137
PSCO,"8/3/2022 6 a.m. MDT",4815,4697,4997,182
PSCO,"8/3/2022 7 a.m. MDT",5014,4761,5234,220
PSCO,"8/3/2022 8 a.m. MDT",5332,4963,5444,112
PSCO,"8/3/2022 9 a.m. MDT",5662,5263,5766,104
PSCO,"8/3/2022 10 a.m. MDT",5852,5612,5998,146
PSCO,"8/3/2022 11 a.m. MDT",6090,5936,6287,197
PSCO,"8/3/2022 12 p.m. MDT",6358,6293,6593,235
PSCO,"8/3/2022 1 p.m. MDT",6696,6606,6993,297
PSCO,"8/3/2022 2 p.m. MDT",6941,6906,7061,120
PSCO,"8/3/2022 3 p.m. MDT",7252,7232,7325,73
PSCO,"8/3/2022 4 p.m. MDT",7447,7319,7480,33
PSCO,"8/3/2022 5 p.m. MDT",7552,7453,7557,5
PSCO,"8/3/2022 6 p.m. MDT",7473,7427,7472,-1
PSCO,"8/3/2022 7 p.m. MDT",7163,7237,7030,-133
PSCO,"8/3/2022 8 p.m. MDT",6819,6995,6766,-53
PSCO,"8/3/2022 9 p.m. MDT",6604,6805,6501,-103
PSCO,"8/3/2022 10 p.m. MDT",6284,6426,6224,-60
PSCO,"8/3/2022 11 p.m. MDT",5796,5836,5733,-63
PSCO,"8/4/2022 12 a.m. MDT",5411,5375,5261,-150
PSCO,"8/4/2022 1 a.m. MDT",5103,5074,5060,-43
PSCO,"8/4/2022 2 a.m. MDT",4825,4823,4732,-93
PSCO,"8/4/2022 3 a.m. MDT",4650,4585,4771,121
PSCO,"8/4/2022 4 a.m. MDT",4521,4449,4617,96
PSCO,"8/4/2022 5 a.m. MDT",4517,4412,4556,39
PSCO,"8/4/2022 6 a.m. MDT",4679,4584,4746,67
PSCO,"8/4/2022 7 a.m. MDT",4876,4748,4878,2
PSCO,"8/4/2022 8 a.m. MDT",5189,4960,5197,8
PSCO,"8/4/2022 9 a.m. MDT",5516,5315,5543,27
PSCO,"8/4/2022 10 a.m. MDT",5850,5668,5835,-15
PSCO,"8/4/2022 11 a.m. MDT",6189,6045,6111,-78
PSCO,"8/4/2022 12 p.m. MDT",6572,6458,6547,-25
PSCO,"8/4/2022 1 p.m. MDT",6977,6925,7078,101
PSCO,"8/4/2022 2 p.m. MDT",7335,7364,7439,104
PSCO,"8/4/2022 3 p.m. MDT",7696,7687,7716,20
PSCO,"8/4/2022 4 p.m. MDT",8047,7933,8089,42
PSCO,"8/4/2022 5 p.m. MDT",8267,8100,8358,91
PSCO,"8/4/2022 6 p.m. MDT",8346,8215,8336,-10
PSCO,"8/4/2022 7 p.m. MDT",8168,7884,8131,-37
PSCO,"8/4/2022 8 p.m. MDT",7814,7574,7675,-139
PSCO,"8/4/2022 9 p.m. MDT",7488,7307,7501,13
PSCO,"8/4/2022 10 p.m. MDT",7117,6942,7242,125
PSCO,"8/4/2022 11 p.m. MDT",6572,6235,6671,99
PSCO,"8/5/2022 12 a.m. MDT",6036,5751,6044,8
PSCO,"8/5/2022 1 a.m. MDT",5728,5283,5837,109
PSCO,"8/5/2022 2 a.m. MDT",5365,4996,5393,28
PSCO,"8/5/2022 3 a.m. MDT",5107,4788,5194,87
PSCO,"8/5/2022 4 a.m. MDT",4958,4614,5056,98
PSCO,"8/5/2022 5 a.m. MDT",4857,4564,4894,37
PSCO,"8/5/2022 6 a.m. MDT",4964,4693,5132,168
PSCO,"8/5/2022 7 a.m. MDT",5119,4813,5254,135
PSCO,"8/5/2022 8 a.m. MDT",5464,5055,5495,31
PSCO,"8/5/2022 9 a.m. MDT",5776,5417,5761,-15
PSCO,"8/5/2022 10 a.m. MDT",6050,5834,5987,-63
PSCO,"8/5/2022 11 a.m. MDT",6552,6295,6355,-197
PSCO,"8/5/2022 12 p.m. MDT",7042,6803,6786,-256
PSCO,"8/5/2022 1 p.m. MDT",7520,7370,7373,-147
PSCO,"8/5/2022 2 p.m. MDT",7926,7768,7826,-100
PSCO,"8/5/2022 3 p.m. MDT",8215,8181,8093,-122
PSCO,"8/5/2022 4 p.m. MDT",8159,8356,8069,-90
PSCO,"8/5/2022 5 p.m. MDT",7896,8244,7861,-35
PSCO,"8/5/2022 6 p.m. MDT",7690,8153,7618,-72
PSCO,"8/5/2022 7 p.m. MDT",7387,7983,7201,-186
PSCO,"8/5/2022 8 p.m. MDT",7118,7522,6901,-217
PSCO,"8/5/2022 9 p.m. MDT",6950,7256,6746,-204
PSCO,"8/5/2022 10 p.m. MDT",6640,6863,6512,-128
PSCO,"8/5/2022 11 p.m. MDT",6183,6271,6223,40
PSCO,"8/6/2022 12 a.m. MDT",5709,5752,5917,208
PSCO,"8/6/2022 1 a.m. MDT",5451,5196,5756,305
PSCO,"8/6/2022 2 a.m. MDT",5169,4882,5452,283
PSCO,"8/6/2022 3 a.m. MDT",4988,4660,5246,258
PSCO,"8/6/2022 4 a.m. MDT",4794,4458,5023,229
PSCO,"8/6/2022 5 a.m. MDT",4726,4362,4978,252
PSCO,"8/6/2022 6 a.m. MDT",4699,4385,5058,359
PSCO,"8/6/2022 7 a.m. MDT",4701,4312,4941,240
PSCO,"8/6/2022 8 a.m. MDT",4774,4457,4767,-7
PSCO,"8/6/2022 9 a.m. MDT",4913,4739,4830,-83
PSCO,"8/6/2022 10 a.m. MDT",5286,5123,5096,-190
PSCO,"8/6/2022 11 a.m. MDT",5687,5552,5521,-166
PSCO,"8/6/2022 12 p.m. MDT",6004,5914,5694,-310
PSCO,"8/6/2022 1 p.m. MDT",6328,6314,6030,-298
PSCO,"8/6/2022 2 p.m. MDT",6692,6617,6362,-330
PSCO,"8/6/2022 3 p.m. MDT",7053,6860,6731,-322
PSCO,"8/6/2022 4 p.m. MDT",7113,7020,6865,-248
PSCO,"8/6/2022 5 p.m. MDT",6987,7203,6660,-327
PSCO,"8/6/2022 6 p.m. MDT",6951,7048,6635,-316
PSCO,"8/6/2022 7 p.m. MDT",6721,6834,6363,-358
PSCO,"8/6/2022 8 p.m. MDT",6434,6556,6213,-221
PSCO,"8/6/2022 9 p.m. MDT",6273,6449,5972,-301
PSCO,"8/6/2022 10 p.m. MDT",5993,6201,5721,-272
PSCO,"8/6/2022 11 p.m. MDT",5586,5748,5584,-2
PSCO,"8/7/2022 12 a.m. MDT",5137,5329,5196,59
PSCO,"8/7/2022 1 a.m. MDT",4808,4915,4955,147
PSCO,"8/7/2022 2 a.m. MDT",4558,4618,4664,106
PSCO,"8/7/2022 3 a.m. MDT",4563,4455,4624,61
PSCO,"8/7/2022 4 a.m. MDT",4484,4266,4479,-5
PSCO,"8/7/2022 5 a.m. MDT",4427,4152,4431,4
PSCO,"8/7/2022 6 a.m. MDT",4433,4147,4473,40
PSCO,"8/7/2022 7 a.m. MDT",4398,4158,4386,-12
PSCO,"8/7/2022 8 a.m. MDT",4457,4201,4340,-117
PSCO,"8/7/2022 9 a.m. MDT",4690,4360,4617,-73
PSCO,"8/7/2022 10 a.m. MDT",4893,4660,4861,-32
PSCO,"8/7/2022 11 a.m. MDT",5163,4912,5173,10
PSCO,"8/7/2022 12 p.m. MDT",5461,5251,5475,14
PSCO,"8/7/2022 1 p.m. MDT",5754,5565,5828,74
PSCO,"8/7/2022 2 p.m. MDT",6034,5832,6035,1
PSCO,"8/7/2022 3 p.m. MDT",6337,6012,6198,-139
PSCO,"8/7/2022 4 p.m. MDT",6663,6090,6512,-151
PSCO,"8/7/2022 5 p.m. MDT",6791,6157,6647,-144
PSCO,"8/7/2022 6 p.m. MDT",6753,6084,6664,-89
PSCO,"8/7/2022 7 p.m. MDT",6564,6004,6361,-203
PSCO,"8/7/2022 8 p.m. MDT",6103,5823,6052,-51
PSCO,"8/7/2022 9 p.m. MDT",5918,5733,5842,-76
PSCO,"8/7/2022 10 p.m. MDT",5617,5597,5492,-125
PSCO,"8/7/2022 11 p.m. MDT",5158,5136,5014,-144
PSCO,"8/8/2022 12 a.m. MDT",4796,4761,4741,-55
PSCO,"8/8/2022 1 a.m. MDT",4493,4386,4516,23
PSCO,"8/8/2022 2 a.m. MDT",4298,4185,4399,101
PSCO,"8/8/2022 3 a.m. MDT",4194,4085,4212,18
PSCO,"8/8/2022 4 a.m. MDT",4143,4018,4108,-35
PSCO,"8/8/2022 5 a.m. MDT",4184,4102,4179,-5
PSCO,"8/8/2022 6 a.m. MDT",4354,4285,4362,8
PSCO,"8/8/2022 7 a.m. MDT",4413,4498,4307,-106
PSCO,"8/8/2022 8 a.m. MDT",4704,4712,4543,-161
PSCO,"8/8/2022 9 a.m. MDT",4927,4965,4787,-140
PSCO,"8/8/2022 10 a.m. MDT",5130,5160,4968,-162
PSCO,"8/8/2022 11 a.m. MDT",5390,5320,5284,-106
PSCO,"8/8/2022 12 p.m. MDT",5710,5616,5595,-115
PSCO,"8/8/2022 1 p.m. MDT",6116,5925,6008,-108
PSCO,"8/8/2022 2 p.m. MDT",6463,6279,6302,-161
PSCO,"8/8/2022 3 p.m. MDT",6833,6528,6666,-167
PSCO,"8/8/2022 4 p.m. MDT",7179,6746,7010,-169
PSCO,"8/8/2022 5 p.m. MDT",7425,6909,7281,-144
PSCO,"8/8/2022 6 p.m. MDT",7645,6974,7547,-98
PSCO,"8/8/2022 7 p.m. MDT",7576,6830,7380,-196
PSCO,"8/8/2022 8 p.m. MDT",7307,6554,7200,-107
PSCO,"8/8/2022 9 p.m. MDT",6982,6430,6776,-206
PSCO,"8/8/2022 10 p.m. MDT",6593,6125,6474,-119
PSCO,"8/8/2022 11 p.m. MDT",6025,5530,5943,-82
PSCO,"8/9/2022 12 a.m. MDT",5516,5035,5486,-30
PSCO,"8/9/2022 1 a.m. MDT",5066,4764,5106,40
PSCO,"8/9/2022 2 a.m. MDT",4736,4514,4959,223
PSCO,"8/9/2022 3 a.m. MDT",4463,4342,4600,137
PSCO,"8/9/2022 4 a.m. MDT",4409,4218,4465,56
PSCO,"8/9/2022 5 a.m. MDT",4447,4259,4492,45
PSCO,"8/9/2022 6 a.m. MDT",4531,4399,4622,91
PSCO,"8/9/2022 7 a.m. MDT",4731,4571,4863,132
PSCO,"8/9/2022 8 a.m. MDT",4961,4778,5024,63
PSCO,"8/9/2022 9 a.m. MDT",5200,5006,5277,77
PSCO,"8/9/2022 10 a.m. MDT",5503,5296,5596,93
PSCO,"8/9/2022 11 a.m. MDT",5917,5624,5790,-127
PSCO,"8/9/2022 12 p.m. MDT",6320,5997,6200,-120
PSCO,"8/9/2022 1 p.m. MDT",6697,6431,6620,-77
PSCO,"8/9/2022 2 p.m. MDT",7127,6816,7088,-39
PSCO,"8/9/2022 3 p.m. MDT",7502,7146,7399,-103
PSCO,"8/9/2022 4 p.m. MDT",7717,7454,7515,-202
PSCO,"8/9/2022 5 p.m. MDT",7868,7809,7676,-192
PSCO,"8/9/2022 6 p.m. MDT",7999,7835,7892,-107
PSCO,"8/9/2022 7 p.m. MDT",7918,7625,7811,-107
PSCO,"8/9/2022 8 p.m. MDT",7656,7312,7645,-11
PSCO,"8/9/2022 9 p.m. MDT",7368,6992,7306,-62
PSCO,"8/9/2022 10 p.m. MDT",6864,6571,6763,-101
PSCO,"8/9/2022 11 p.m. MDT",6207,5948,6244,37
PSCO,"8/10/2022 12 a.m. MDT",5708,5418,5960,252
PSCO,"8/10/2022 1 a.m. MDT",5387,5137,5631,244
PSCO,"8/10/2022 2 a.m. MDT",5023,4852,5193,170
PSCO,"8/10/2022 3 a.m. MDT",4785,4606,5069,284
PSCO,"8/10/2022 4 a.m. MDT",4648,4453,4916,268
PSCO,"8/10/2022 5 a.m. MDT",4631,4445,4857,226
PSCO,"8/10/2022 6 a.m. MDT",4762,4561,4908,146
PSCO,"8/10/2022 7 a.m. MDT",4790,4756,4840,50
PSCO,"8/10/2022 8 a.m. MDT",4992,4985,5112,120
PSCO,"8/10/2022 9 a.m. MDT",5311,5215,5370,59
PSCO,"8/10/2022 10 a.m. MDT",5614,5592,5835,221
PSCO,"8/10/2022 11 a.m. MDT",6005,5992,6138,133
PSCO,"8/10/2022 12 p.m. MDT",6420,6447,6535,115
PSCO,"8/10/2022 1 p.m. MDT",6801,6934,6918,117
PSCO,"8/10/2022 2 p.m. MDT",7144,7350,7249,105
PSCO,"8/10/2022 3 p.m. MDT",7489,7679,7492,3
PSCO,"8/10/2022 4 p.m. MDT",7786,7961,7745,-41
PSCO,"8/10/2022 5 p.m. MDT",8088,8281,8015,-73
PSCO,"8/10/2022 6 p.m. MDT",8192,8318,8227,35
PSCO,"8/10/2022 7 p.m. MDT",8124,8050,8145,21
PSCO,"8/10/2022 8 p.m. MDT",7813,7678,7917,104
PSCO,"8/10/2022 9 p.m. MDT",7419,7353,7529,110
PSCO,"8/10/2022 10 p.m. MDT",7001,6905,7116,115
PSCO,"8/10/2022 11 p.m. MDT",6328,6246,6515,187
PSCO,"8/11/2022 12 a.m. MDT",5842,5690,5950,108
PSCO,"8/11/2022 1 a.m. MDT",5430,5272,5702,272
PSCO,"8/11/2022 2 a.m. MDT",5079,4969,5398,319
PSCO,"8/11/2022 3 a.m. MDT",4956,4726,5247,291
PSCO,"8/11/2022 4 a.m. MDT",4846,4535,5059,213
PSCO,"8/11/2022 5 a.m. MDT",4769,4504,4934,165
PSCO,"8/11/2022 6 a.m. MDT",4904,4621,5102,198
PSCO,"8/11/2022 7 a.m. MDT",5079,4827,5356,277
PSCO,"8/11/2022 8 a.m. MDT",5352,5068,5320,-32
PSCO,"8/11/2022 9 a.m. MDT",5553,5308,5621,68
PSCO,"8/11/2022 10 a.m. MDT",5821,5679,5870,49
PSCO,"8/11/2022 11 a.m. MDT",6264,6141,6267,3
PSCO,"8/11/2022 12 p.m. MDT",6650,6615,6671,21
PSCO,"8/11/2022 1 p.m. MDT",7086,7104,7151,65
PSCO,"8/11/2022 2 p.m. MDT",7428,7552,7495,67
PSCO,"8/11/2022 3 p.m. MDT",7863,7878,7918,55
PSCO,"8/11/2022 4 p.m. MDT",8182,8180,8335,153
PSCO,"8/11/2022 5 p.m. MDT",8430,8462,8479,49
PSCO,"8/11/2022 6 p.m. MDT",8439,8550,8474,35
PSCO,"8/11/2022 7 p.m. MDT",8227,8241,8187,-40
PSCO,"8/11/2022 8 p.m. MDT",7859,7785,7838,-21
PSCO,"8/11/2022 9 p.m. MDT",7529,7539,7496,-33
PSCO,"8/11/2022 10 p.m. MDT",7058,7092,7006,-52
PSCO,"8/11/2022 11 p.m. MDT",6376,6405,6347,-29
PSCO,"8/12/2022 12 a.m. MDT",5917,5850,5849,-68
PSCO,"8/12/2022 1 a.m. MDT",5353,5306,5252,-101
PSCO,"8/12/2022 2 a.m. MDT",4999,5023,4882,-117
PSCO,"8/12/2022 3 a.m. MDT",4731,4781,4779,48
PSCO,"8/12/2022 4 a.m. MDT",4566,4573,4706,140
PSCO,"8/12/2022 5 a.m. MDT",4567,4539,4685,118
PSCO,"8/12/2022 6 a.m. MDT",4658,4590,4679,21
PSCO,"8/12/2022 7 a.m. MDT",4850,4761,4910,60
PSCO,"8/12/2022 8 a.m. MDT",5152,5000,5057,-95
PSCO,"8/12/2022 9 a.m. MDT",5401,5266,5126,-275
PSCO,"8/12/2022 10 a.m. MDT",5699,5696,5567,-132
PSCO,"8/12/2022 11 a.m. MDT",6038,6077,6017,-21
PSCO,"8/12/2022 12 p.m. MDT",6391,6557,6193,-198
PSCO,"8/12/2022 1 p.m. MDT",6745,7017,6658,-87
PSCO,"8/12/2022 2 p.m. MDT",7104,7455,7040,-64
PSCO,"8/12/2022 3 p.m. MDT",7459,7835,7296,-163
PSCO,"8/12/2022 4 p.m. MDT",7643,7979,7482,-161
PSCO,"8/12/2022 5 p.m. MDT",7875,8327,7703,-172
PSCO,"8/12/2022 6 p.m. MDT",7982,8268,7821,-161
PSCO,"8/12/2022 7 p.m. MDT",7818,8064,7744,-74
PSCO,"8/12/2022 8 p.m. MDT",7665,7653,7568,-97
PSCO,"8/12/2022 9 p.m. MDT",7345,7368,7146,-199
PSCO,"8/12/2022 10 p.m. MDT",6887,6894,6612,-275
PSCO,"8/12/2022 11 p.m. MDT",6325,6297,6003,-322
PSCO,"8/13/2022 12 a.m. MDT",5912,5775,5679,-233
PSCO,"8/13/2022 1 a.m. MDT",5593,5194,5223,-370
PSCO,"8/13/2022 2 a.m. MDT",5210,4847,4998,-212
PSCO,"8/13/2022 3 a.m. MDT",4921,4675,4759,-162
PSCO,"8/13/2022 4 a.m. MDT",4676,4479,4388,-288
PSCO,"8/13/2022 5 a.m. MDT",4576,4375,4230,-346
PSCO,"8/13/2022 6 a.m. MDT",4540,4400,4296,-244
PSCO,"8/13/2022 7 a.m. MDT",4382,4370,4301,-81
PSCO,"8/13/2022 8 a.m. MDT",4598,4468,4487,-111
PSCO,"8/13/2022 9 a.m. MDT",4824,4731,4663,-161
PSCO,"8/13/2022 10 a.m. MDT",5099,5201,4937,-162
PSCO,"8/13/2022 11 a.m. MDT",5453,5643,5156,-297
PSCO,"8/13/2022 12 p.m. MDT",5859,6045,5428,-431
PSCO,"8/13/2022 1 p.m. MDT",6184,6445,5851,-333
PSCO,"8/13/2022 2 p.m. MDT",6579,6790,6286,-293
PSCO,"8/13/2022 3 p.m. MDT",6918,7177,6714,-204
PSCO,"8/13/2022 4 p.m. MDT",7258,7534,7062,-196
PSCO,"8/13/2022 5 p.m. MDT",7524,7794,7311,-213
PSCO,"8/13/2022 6 p.m. MDT",7544,7787,7338,-206
PSCO,"8/13/2022 7 p.m. MDT",7254,7619,7037,-217
PSCO,"8/13/2022 8 p.m. MDT",6870,7393,6626,-244
PSCO,"8/13/2022 9 p.m. MDT",6535,7104,6201,-334
PSCO,"8/13/2022 10 p.m. MDT",6127,6690,5748,-379
PSCO,"8/13/2022 11 p.m. MDT",5701,6146,5286,-415
PSCO,"8/14/2022 12 a.m. MDT",5309,5663,4911,-398
PSCO,"8/14/2022 1 a.m. MDT",5067,5076,4722,-345
PSCO,"8/14/2022 2 a.m. MDT",4787,4711,4487,-300
PSCO,"8/14/2022 3 a.m. MDT",4583,4480,4311,-272
PSCO,"8/14/2022 4 a.m. MDT",4462,4319,4140,-322
PSCO,"8/14/2022 5 a.m. MDT",4357,4188,4133,-224
PSCO,"8/14/2022 6 a.m. MDT",4317,4203,4061,-256
PSCO,"8/14/2022 7 a.m. MDT",4303,4203,4023,-280
PSCO,"8/14/2022 8 a.m. MDT",4539,4315,4132,-407
PSCO,"8/14/2022 9 a.m. MDT",4710,4527,4314,-396
PSCO,"8/14/2022 10 a.m. MDT",4882,4844,4466,-416
PSCO,"8/14/2022 11 a.m. MDT",5325,5263,4954,-371
PSCO,"8/14/2022 12 p.m. MDT",5784,5771,5499,-285
PSCO,"8/14/2022 1 p.m. MDT",6237,6192,5953,-284
PSCO,"8/14/2022 2 p.m. MDT",6692,6627,6313,-379
PSCO,"8/14/2022 3 p.m. MDT",7066,6935,6826,-240
PSCO,"8/14/2022 4 p.m. MDT",7098,7225,6803,-295
PSCO,"8/14/2022 5 p.m. MDT",6907,7332,6750,-157
PSCO,"8/14/2022 6 p.m. MDT",6844,7276,6719,-125
PSCO,"8/14/2022 7 p.m. MDT",6691,6964,6494,-197
PSCO,"8/14/2022 8 p.m. MDT",6376,6597,6352,-24
PSCO,"8/14/2022 9 p.m. MDT",6210,6603,6005,-205
PSCO,"8/14/2022 10 p.m. MDT",5942,6214,5698,-244
PSCO,"8/14/2022 11 p.m. MDT",5465,5666,5147,-318
PSCO,"8/15/2022 12 a.m. MDT",5019,5157,4688,-331
PSCO,"8/15/2022 1 a.m. MDT",4684,4838,4538,-146
PSCO,"8/15/2022 2 a.m. MDT",4643,4550,4470,-173
PSCO,"8/15/2022 3 a.m. MDT",4501,4360,4280,-221
PSCO,"8/15/2022 4 a.m. MDT",4417,4250,4205,-212
PSCO,"8/15/2022 5 a.m. MDT",4465,4238,4265,-200
PSCO,"8/15/2022 6 a.m. MDT",4619,4420,4373,-246
PSCO,"8/15/2022 7 a.m. MDT",4694,4624,4460,-234
PSCO,"8/15/2022 8 a.m. MDT",4917,4939,4766,-151
PSCO,"8/15/2022 9 a.m. MDT",5183,5194,4938,-245
PSCO,"8/15/2022 10 a.m. MDT",5460,5474,5242,-218
PSCO,"8/15/2022 11 a.m. MDT",5750,5708,5564,-186
PSCO,"8/15/2022 12 p.m. MDT",6068,6024,5879,-189
PSCO,"8/15/2022 1 p.m. MDT",6413,6417,6118,-295
PSCO,"8/15/2022 2 p.m. MDT",6860,6692,6610,-250
PSCO,"8/15/2022 3 p.m. MDT",6966,6875,6853,-113
PSCO,"8/15/2022 4 p.m. MDT",6559,6950,6455,-104
PSCO,"8/15/2022 5 p.m. MDT",6151,6944,6019,-132
PSCO,"8/15/2022 6 p.m. MDT",6025,6834,5945,-80
PSCO,"8/15/2022 7 p.m. MDT",5803,6553,5753,-50
PSCO,"8/15/2022 8 p.m. MDT",5633,6239,5571,-62
PSCO,"8/15/2022 9 p.m. MDT",5541,6117,5496,-45
PSCO,"8/15/2022 10 p.m. MDT",5296,5776,5176,-120
PSCO,"8/15/2022 11 p.m. MDT",4999,5294,4890,-109
PSCO,"8/16/2022 12 a.m. MDT",4770,4872,4683,-87
PSCO,"8/16/2022 1 a.m. MDT",4465,4436,4209,-256
PSCO,"8/16/2022 2 a.m. MDT",4196,4221,3807,-389
PSCO,"8/16/2022 3 a.m. MDT",3941,4095,3628,-313
PSCO,"8/16/2022 4 a.m. MDT",3868,4057,3577,-291
PSCO,"8/16/2022 5 a.m. MDT",3958,4135,3641,-317
PSCO,"8/16/2022 6 a.m. MDT",4201,4337,4016,-185
PSCO,"8/16/2022 7 a.m. MDT",4548,4569,4346,-202
PSCO,"8/16/2022 8 a.m. MDT",4777,4779,4734,-43
PSCO,"8/16/2022 9 a.m. MDT",4941,4989,4791,-150
PSCO,"8/16/2022 10 a.m. MDT",5117,5196,4856,-261
PSCO,"8/16/2022 11 a.m. MDT",5181,5319,5042,-139
PSCO,"8/16/2022 12 p.m. MDT",5232,5434,5090,-142
PSCO,"8/16/2022 1 p.m. MDT",5303,5649,5143,-160
PSCO,"8/16/2022 2 p.m. MDT",5264,5969,5249,-15
PSCO,"8/16/2022 3 p.m. MDT",5366,6115,5304,-62
PSCO,"8/16/2022 4 p.m. MDT",5436,6293,5418,-18
PSCO,"8/16/2022 5 p.m. MDT",5403,6543,5402,-1
PSCO,"8/16/2022 6 p.m. MDT",5517,6573,5530,13
PSCO,"8/16/2022 7 p.m. MDT",5436,6434,5409,-27
PSCO,"8/16/2022 8 p.m. MDT",5331,6133,5135,-196
PSCO,"8/16/2022 9 p.m. MDT",5273,5986,5238,-35
PSCO,"8/16/2022 10 p.m. MDT",5106,5662,5090,-16
PSCO,"8/16/2022 11 p.m. MDT",4727,5179,4521,-206
PSCO,"8/17/2022 12 a.m. MDT",4339,4776,4074,-265
PSCO,"8/17/2022 1 a.m. MDT",4050,4434,3744,-306
PSCO,"8/17/2022 2 a.m. MDT",3938,4200,3629,-309
PSCO,"8/17/2022 3 a.m. MDT",3792,3986,3480,-312
PSCO,"8/17/2022 4 a.m. MDT",3746,3946,3432,-314
PSCO,"8/17/2022 5 a.m. MDT",3815,3999,3509,-306
PSCO,"8/17/2022 6 a.m. MDT",4024,4183,3718,-306
PSCO,"8/17/2022 7 a.m. MDT",4282,4376,4062,-220
PSCO,"8/17/2022 8 a.m. MDT",4448,4525,4240,-208
PSCO,"8/17/2022 9 a.m. MDT",4583,4687,4243,-340
PSCO,"8/17/2022 10 a.m. MDT",4678,4888,4261,-417
PSCO,"8/17/2022 11 a.m. MDT",4836,5057,4444,-392
PSCO,"8/17/2022 12 p.m. MDT",5042,5297,4632,-410
PSCO,"8/17/2022 1 p.m. MDT",5258,5635,4870,-388
PSCO,"8/17/2022 2 p.m. MDT",5446,5996,5163,-283
PSCO,"8/17/2022 3 p.m. MDT",5707,6322,5405,-302
PSCO,"8/17/2022 4 p.m. MDT",6021,6668,5820,-201
PSCO,"8/17/2022 5 p.m. MDT",6342,6967,6190,-152
PSCO,"8/17/2022 6 p.m. MDT",6554,7094,6404,-150
PSCO,"8/17/2022 7 p.m. MDT",6553,6938,6462,-91
PSCO,"8/17/2022 8 p.m. MDT",6348,6684,6275,-73
PSCO,"8/17/2022 9 p.m. MDT",6046,6383,5919,-127
PSCO,"8/17/2022 10 p.m. MDT",5699,5970,5466,-233
PSCO,"8/17/2022 11 p.m. MDT",5154,5412,4940,-214
PSCO,"8/18/2022 12 a.m. MDT",4641,4986,4492,-149
PSCO,"8/18/2022 1 a.m. MDT",4411,4481,4286,-125
PSCO,"8/18/2022 2 a.m. MDT",4272,4210,4270,-2
PSCO,"8/18/2022 3 a.m. MDT",4134,4050,4044,-90
PSCO,"8/18/2022 4 a.m. MDT",4040,3978,4037,-3
PSCO,"8/18/2022 5 a.m. MDT",4004,4012,3886,-118
PSCO,"8/18/2022 6 a.m. MDT",4067,4163,3974,-93
PSCO,"8/18/2022 7 a.m. MDT",4271,4356,4136,-135
PSCO,"8/18/2022 8 a.m. MDT",4413,4559,4376,-37
PSCO,"8/18/2022 9 a.m. MDT",4572,4723,4564,-8
PSCO,"8/18/2022 10 a.m. MDT",4750,4929,4737,-13
PSCO,"8/18/2022 11 a.m. MDT",5005,5159,4955,-50
PSCO,"8/18/2022 12 p.m. MDT",5247,5429,5205,-42
PSCO,"8/18/2022 1 p.m. MDT",5569,5768,5574,5
PSCO,"8/18/2022 2 p.m. MDT",5877,6130,5871,-6
PSCO,"8/18/2022 3 p.m. MDT",6203,6429,6272,69
PSCO,"8/18/2022 4 p.m. MDT",6564,6772,6571,7
PSCO,"8/18/2022 5 p.m. MDT",6839,7136,6810,-29
PSCO,"8/18/2022 6 p.m. MDT",7008,7229,7103,95
PSCO,"8/18/2022 7 p.m. MDT",6928,7005,7013,85
PSCO,"8/18/2022 8 p.m. MDT",6698,6708,6759,61
PSCO,"8/18/2022 9 p.m. MDT",6405,6547,6537,132
PSCO,"8/18/2022 10 p.m. MDT",5926,6101,5931,5
PSCO,"8/18/2022 11 p.m. MDT",5327,5483,5347,20
PSCO,"8/19/2022 12 a.m. MDT",4798,5031,4846,48
PSCO,"8/19/2022 1 a.m. MDT",4410,4639,4398,-12
PSCO,"8/19/2022 2 a.m. MDT",4168,4312,4217,49
PSCO,"8/19/2022 3 a.m. MDT",3991,4084,4090,99
PSCO,"8/19/2022 4 a.m. MDT",3910,4022,4001,91
PSCO,"8/19/2022 5 a.m. MDT",3915,4046,4004,89
PSCO,"8/19/2022 6 a.m. MDT",4082,4190,4153,71
PSCO,"8/19/2022 7 a.m. MDT",4292,4394,4315,23
PSCO,"8/19/2022 8 a.m. MDT",4457,4591,4512,55
PSCO,"8/19/2022 9 a.m. MDT",4668,4732,4574,-94
PSCO,"8/19/2022 10 a.m. MDT",4871,4972,4747,-124
PSCO,"8/19/2022 11 a.m. MDT",4997,5127,4893,-104
PSCO,"8/19/2022 12 p.m. MDT",5154,5338,5045,-109
PSCO,"8/19/2022 1 p.m. MDT",5419,5574,5254,-165
PSCO,"8/19/2022 2 p.m. MDT",5726,5941,5610,-116
PSCO,"8/19/2022 3 p.m. MDT",6026,6200,6026,0
PSCO,"8/19/2022 4 p.m. MDT",6247,6383,6144,-103
PSCO,"8/19/2022 5 p.m. MDT",6369,6524,6233,-136
PSCO,"8/19/2022 6 p.m. MDT",6326,6464,6171,-155
PSCO,"8/19/2022 7 p.m. MDT",6079,6225,5922,-157
PSCO,"8/19/2022 8 p.m. MDT",5858,5957,5651,-207
PSCO,"8/19/2022 9 p.m. MDT",5721,5867,5503,-218
PSCO,"8/19/2022 10 p.m. MDT",5446,5575,5295,-151
PSCO,"8/19/2022 11 p.m. MDT",5071,5128,4905,-166
PSCO,"8/20/2022 12 a.m. MDT",4661,4706,4550,-111
PSCO,"8/20/2022 1 a.m. MDT",4357,4428,4280,-77
PSCO,"8/20/2022 2 a.m. MDT",4136,4228,4022,-114
PSCO,"8/20/2022 3 a.m. MDT",3983,4002,3883,-100
PSCO,"8/20/2022 4 a.m. MDT",3887,3931,3776,-111
PSCO,"8/20/2022 5 a.m. MDT",3812,3885,3738,-74
PSCO,"8/20/2022 6 a.m. MDT",3825,3931,3739,-86
PSCO,"8/20/2022 7 a.m. MDT",3857,4000,3782,-75
PSCO,"8/20/2022 8 a.m. MDT",3971,4116,3862,-109
PSCO,"8/20/2022 9 a.m. MDT",4127,4280,3968,-159
PSCO,"8/20/2022 10 a.m. MDT",4289,4356,4101,-188
PSCO,"8/20/2022 11 a.m. MDT",4415,4561,4344,-71
PSCO,"8/20/2022 12 p.m. MDT",4544,4733,4413,-131
PSCO,"8/20/2022 1 p.m. MDT",4704,4856,4623,-81
PSCO,"8/20/2022 2 p.m. MDT",4925,5055,4890,-35
PSCO,"8/20/2022 3 p.m. MDT",5181,5230,5128,-53
PSCO,"8/20/2022 4 p.m. MDT",5402,5481,5466,64
PSCO,"8/20/2022 5 p.m. MDT",5449,5604,5571,122
PSCO,"8/20/2022 6 p.m. MDT",5316,5751,5477,161
PSCO,"8/20/2022 7 p.m. MDT",5220,5606,5413,193
PSCO,"8/20/2022 8 p.m. MDT",5251,5398,5070,-181
PSCO,"8/20/2022 9 p.m. MDT",5196,5401,4970,-226
PSCO,"8/20/2022 10 p.m. MDT",4990,5158,4802,-188
PSCO,"8/20/2022 11 p.m. MDT",4725,4842,4490,-235
PSCO,"8/21/2022 12 a.m. MDT",4410,4505,4334,-76
PSCO,"8/21/2022 1 a.m. MDT",4185,4260,4059,-126
PSCO,"8/21/2022 2 a.m. MDT",3991,4095,3994,3
PSCO,"8/21/2022 3 a.m. MDT",3750,3971,3824,74
PSCO,"8/21/2022 4 a.m. MDT",3651,3916,3672,21
PSCO,"8/21/2022 5 a.m. MDT",3563,3864,3529,-34
PSCO,"8/21/2022 6 a.m. MDT",3700,3880,3484,-216
PSCO,"8/21/2022 7 a.m. MDT",3765,3859,3582,-183
PSCO,"8/21/2022 8 a.m. MDT",3866,3929,3650,-216
PSCO,"8/21/2022 9 a.m. MDT",3988,4060,3845,-143
PSCO,"8/21/2022 10 a.m. MDT",4116,4269,4139,23
PSCO,"8/21/2022 11 a.m. MDT",4310,4491,4350,40
PSCO,"8/21/2022 12 p.m. MDT",4547,4754,4519,-28
PSCO,"8/21/2022 1 p.m. MDT",4810,5047,4783,-27
PSCO,"8/21/2022 2 p.m. MDT",5092,5354,5062,-30
PSCO,"8/21/2022 3 p.m. MDT",5473,5629,5324,-149
PSCO,"8/21/2022 4 p.m. MDT",5663,5903,5592,-71
PSCO,"8/21/2022 5 p.m. MDT",5618,6063,5502,-116
PSCO,"8/21/2022 6 p.m. MDT",5626,6239,5410,-216
PSCO,"8/21/2022 7 p.m. MDT",5486,6193,5313,-173
PSCO,"8/21/2022 8 p.m. MDT",5379,5939,5126,-253
PSCO,"8/21/2022 9 p.m. MDT",5322,5907,5102,-220
PSCO,"8/21/2022 10 p.m. MDT",5080,5586,4813,-267
PSCO,"8/21/2022 11 p.m. MDT",4623,5107,4417,-206
PSCO,"8/22/2022 12 a.m. MDT",4258,4721,4009,-249
PSCO,"8/22/2022 1 a.m. MDT",4010,4317,3849,-161
PSCO,"8/22/2022 2 a.m. MDT",3878,4108,3766,-112
PSCO,"8/22/2022 3 a.m. MDT",3903,3973,3725,-178
PSCO,"8/22/2022 4 a.m. MDT",3877,3917,3678,-199
PSCO,"8/22/2022 5 a.m. MDT",3937,3983,3739,-198
PSCO,"8/22/2022 6 a.m. MDT",3975,4165,3797,-178
PSCO,"8/22/2022 7 a.m. MDT",4250,4434,4085,-165
PSCO,"8/22/2022 8 a.m. MDT",4504,4653,4305,-199
PSCO,"8/22/2022 9 a.m. MDT",4678,4815,4486,-192
PSCO,"8/22/2022 10 a.m. MDT",4850,4980,4732,-118
PSCO,"8/22/2022 11 a.m. MDT",5050,5089,4921,-129
PSCO,"8/22/2022 12 p.m. MDT",5326,5284,5218,-108
PSCO,"8/22/2022 1 p.m. MDT",5618,5534,5503,-115
PSCO,"8/22/2022 2 p.m. MDT",5930,5854,5824,-106
PSCO,"8/22/2022 3 p.m. MDT",6260,6056,6293,33
PSCO,"8/22/2022 4 p.m. MDT",6494,6176,6463,-31
PSCO,"8/22/2022 5 p.m. MDT",6665,6333,6618,-47
PSCO,"8/22/2022 6 p.m. MDT",6737,6471,6682,-55
PSCO,"8/22/2022 7 p.m. MDT",6603,6368,6577,-26
PSCO,"8/22/2022 8 p.m. MDT",6313,6246,6314,1
PSCO,"8/22/2022 9 p.m. MDT",6089,6071,6000,-89
PSCO,"8/22/2022 10 p.m. MDT",5679,5683,5607,-72
PSCO,"8/22/2022 11 p.m. MDT",5139,5171,5005,-134
PSCO,"8/23/2022 12 a.m. MDT",4791,4758,4636,-155
PSCO,"8/23/2022 1 a.m. MDT",4475,4354,4390,-85
PSCO,"8/23/2022 2 a.m. MDT",4344,4109,4119,-225
PSCO,"8/23/2022 3 a.m. MDT",4205,3984,4007,-198
PSCO,"8/23/2022 4 a.m. MDT",4119,3904,3904,-215
PSCO,"8/23/2022 5 a.m. MDT",4102,3930,3904,-198
PSCO,"8/23/2022 6 a.m. MDT",4042,4090,3880,-162
PSCO,"8/23/2022 7 a.m. MDT",4285,4372,4063,-222
PSCO,"8/23/2022 8 a.m. MDT",4511,4554,4441,-70
PSCO,"8/23/2022 9 a.m. MDT",4671,4713,4597,-74
PSCO,"8/23/2022 10 a.m. MDT",4879,4880,4796,-83
PSCO,"8/23/2022 11 a.m. MDT",5101,5131,5168,67
PSCO,"8/23/2022 12 p.m. MDT",5350,5359,5322,-28
PSCO,"8/23/2022 1 p.m. MDT",5674,5655,5679,5
PSCO,"8/23/2022 2 p.m. MDT",5965,5990,5929,-36
PSCO,"8/23/2022 3 p.m. MDT",6214,6303,6245,31
PSCO,"8/23/2022 4 p.m. MDT",6482,6644,6502,20
PSCO,"8/23/2022 5 p.m. MDT",6888,6895,6865,-23
PSCO,"8/23/2022 6 p.m. MDT",7042,6985,7020,-22
PSCO,"8/23/2022 7 p.m. MDT",6857,6862,6894,37
PSCO,"8/23/2022 8 p.m. MDT",6547,6598,6567,20
PSCO,"8/23/2022 9 p.m. MDT",6241,6346,6196,-45
PSCO,"8/23/2022 10 p.m. MDT",5815,5993,5720,-95
PSCO,"8/23/2022 11 p.m. MDT",5214,5375,5010,-204
PSCO,"8/24/2022 12 a.m. MDT",4805,4934,4618,-187
PSCO,"8/24/2022 1 a.m. MDT",4547,4571,4390,-157
PSCO,"8/24/2022 2 a.m. MDT",4261,4315,4255,-6
PSCO,"8/24/2022 3 a.m. MDT",4089,4135,4132,43
PSCO,"8/24/2022 4 a.m. MDT",4023,4033,4030,7
PSCO,"8/24/2022 5 a.m. MDT",4056,4061,4036,-20
PSCO,"8/24/2022 6 a.m. MDT",4103,4217,4085,-18
PSCO,"8/24/2022 7 a.m. MDT",4344,4550,4296,-48
PSCO,"8/24/2022 8 a.m. MDT",4512,4719,4533,21
PSCO,"8/24/2022 9 a.m. MDT",4624,4807,4561,-63
PSCO,"8/24/2022 10 a.m. MDT",4806,5050,4686,-120
PSCO,"8/24/2022 11 a.m. MDT",4936,5261,4760,-176
PSCO,"8/24/2022 12 p.m. MDT",5238,5544,4968,-270
PSCO,"8/24/2022 1 p.m. MDT",5539,5909,5369,-170
PSCO,"8/24/2022 2 p.m. MDT",5901,6261,5737,-164
PSCO,"8/24/2022 3 p.m. MDT",6296,6616,6213,-83
PSCO,"8/24/2022 4 p.m. MDT",6622,6948,6535,-87
PSCO,"8/24/2022 5 p.m. MDT",6920,7236,6847,-73
PSCO,"8/24/2022 6 p.m. MDT",7077,7356,7024,-53
PSCO,"8/24/2022 7 p.m. MDT",6974,7137,6959,-15
PSCO,"8/24/2022 8 p.m. MDT",6695,6864,6675,-20
PSCO,"8/24/2022 9 p.m. MDT",6394,6584,6286,-108
PSCO,"8/24/2022 10 p.m. MDT",5919,6095,5725,-194
PSCO,"8/24/2022 11 p.m. MDT",5367,5507,5138,-229
PSCO,"8/25/2022 12 a.m. MDT",4963,5008,4714,-249
PSCO,"8/25/2022 1 a.m. MDT",4618,4599,4463,-155
PSCO,"8/25/2022 2 a.m. MDT",4430,4323,4349,-81
PSCO,"8/25/2022 3 a.m. MDT",4267,4152,4177,-90
PSCO,"8/25/2022 4 a.m. MDT",4186,4047,4047,-139
PSCO,"8/25/2022 5 a.m. MDT",4120,4061,4016,-104
PSCO,"8/25/2022 6 a.m. MDT",4132,4212,4083,-49
PSCO,"8/25/2022 7 a.m. MDT",4333,4489,4173,-160
PSCO,"8/25/2022 8 a.m. MDT",4576,4684,4488,-88
PSCO,"8/25/2022 9 a.m. MDT",4662,4798,4363,-299
PSCO,"8/25/2022 10 a.m. MDT",4874,5001,4608,-266
PSCO,"8/25/2022 11 a.m. MDT",5048,5232,4845,-203
PSCO,"8/25/2022 12 p.m. MDT",5304,5541,5139,-165
PSCO,"8/25/2022 1 p.m. MDT",5762,5883,5771,9
PSCO,"8/25/2022 2 p.m. MDT",6209,6247,6181,-28
PSCO,"8/25/2022 3 p.m. MDT",6410,6600,6413,3
PSCO,"8/25/2022 4 p.m. MDT",6249,6815,6280,31
PSCO,"8/25/2022 5 p.m. MDT",6166,7038,6072,-94
PSCO,"8/25/2022 6 p.m. MDT",6026,6989,5919,-107
PSCO,"8/25/2022 7 p.m. MDT",5801,6742,5885,84
PSCO,"8/25/2022 8 p.m. MDT",5690,6398,5692,2
PSCO,"8/25/2022 9 p.m. MDT",5582,6254,5573,-9
PSCO,"8/25/2022 10 p.m. MDT",5298,5860,5275,-23
PSCO,"8/25/2022 11 p.m. MDT",4913,5328,4903,-10
PSCO,"8/26/2022 12 a.m. MDT",4529,4898,4627,98
PSCO,"8/26/2022 1 a.m. MDT",4233,4556,4472,239
PSCO,"8/26/2022 2 a.m. MDT",4293,4301,4255,-38
PSCO,"8/26/2022 3 a.m. MDT",4188,4105,4212,24
PSCO,"8/26/2022 4 a.m. MDT",4147,4034,4136,-11
PSCO,"8/26/2022 5 a.m. MDT",4190,4060,4122,-68
PSCO,"8/26/2022 6 a.m. MDT",4310,4236,4290,-20
PSCO,"8/26/2022 7 a.m. MDT",4465,4524,4343,-122
PSCO,"8/26/2022 8 a.m. MDT",4624,4702,4498,-126
PSCO,"8/26/2022 9 a.m. MDT",4773,4866,4604,-169
PSCO,"8/26/2022 10 a.m. MDT",4884,5073,4662,-222
PSCO,"8/26/2022 11 a.m. MDT",5069,5215,4900,-169
PSCO,"8/26/2022 12 p.m. MDT",5248,5472,5113,-135
PSCO,"8/26/2022 1 p.m. MDT",5489,5761,5387,-102
PSCO,"8/26/2022 2 p.m. MDT",5832,6050,5625,-207
PSCO,"8/26/2022 3 p.m. MDT",6126,6250,5901,-225
PSCO,"8/26/2022 4 p.m. MDT",6215,6448,5954,-261
PSCO,"8/26/2022 5 p.m. MDT",6112,6560,5926,-186
PSCO,"8/26/2022 6 p.m. MDT",5983,6461,5743,-240
PSCO,"8/26/2022 7 p.m. MDT",5692,6167,5409,-283
PSCO,"8/26/2022 8 p.m. MDT",5523,5980,5220,-303
PSCO,"8/26/2022 9 p.m. MDT",5385,5846,5059,-326
PSCO,"8/26/2022 10 p.m. MDT",5122,5523,4762,-360
PSCO,"8/26/2022 11 p.m. MDT",4793,5110,4486,-307
PSCO,"8/27/2022 12 a.m. MDT",4448,4715,4109,-339
PSCO,"8/27/2022 1 a.m. MDT",4261,4583,4090,-171
PSCO,"8/27/2022 2 a.m. MDT",4060,4393,3860,-200
PSCO,"8/27/2022 3 a.m. MDT",3917,4197,3695,-222
PSCO,"8/27/2022 4 a.m. MDT",3840,4097,3636,-204
PSCO,"8/27/2022 5 a.m. MDT",3808,4012,3537,-271
PSCO,"8/27/2022 6 a.m. MDT",3872,4038,3584,-288
PSCO,"8/27/2022 7 a.m. MDT",3948,4089,3725,-223
PSCO,"8/27/2022 8 a.m. MDT",4046,4194,3791,-255
PSCO,"8/27/2022 9 a.m. MDT",4225,4421,4124,-101
PSCO,"8/27/2022 10 a.m. MDT",4449,4746,4410,-39
PSCO,"8/27/2022 11 a.m. MDT",4716,5003,4630,-86
PSCO,"8/27/2022 12 p.m. MDT",5007,5355,4893,-114
PSCO,"8/27/2022 1 p.m. MDT",5315,5720,5206,-109
PSCO,"8/27/2022 2 p.m. MDT",5567,5994,5413,-154
PSCO,"8/27/2022 3 p.m. MDT",5861,6293,5671,-190
PSCO,"8/27/2022 4 p.m. MDT",6161,6556,5961,-200
PSCO,"8/27/2022 5 p.m. MDT",6389,6834,6032,-357
PSCO,"8/27/2022 6 p.m. MDT",6399,6745,6011,-388
PSCO,"8/27/2022 7 p.m. MDT",6229,6556,5874,-355
PSCO,"8/27/2022 8 p.m. MDT",5898,6259,5493,-405
PSCO,"8/27/2022 9 p.m. MDT",5632,6076,5238,-394
PSCO,"8/27/2022 10 p.m. MDT",5280,5767,4948,-332
PSCO,"8/27/2022 11 p.m. MDT",4924,5385,4708,-216
PSCO,"8/28/2022 12 a.m. MDT",4595,4944,4459,-136
PSCO,"8/28/2022 1 a.m. MDT",4283,4492,4170,-113
PSCO,"8/28/2022 2 a.m. MDT",4116,4284,4137,21
PSCO,"8/28/2022 3 a.m. MDT",4101,4098,4056,-45
PSCO,"8/28/2022 4 a.m. MDT",3985,4012,4083,98
PSCO,"8/28/2022 5 a.m. MDT",3930,3930,3912,-18
PSCO,"8/28/2022 6 a.m. MDT",4015,3954,3994,-21
PSCO,"8/28/2022 7 a.m. MDT",4033,3973,4112,79
PSCO,"8/28/2022 8 a.m. MDT",3939,4003,3941,2
PSCO,"8/28/2022 9 a.m. MDT",4135,4178,4020,-115
PSCO,"8/28/2022 10 a.m. MDT",4423,4418,4461,38
PSCO,"8/28/2022 11 a.m. MDT",4796,4805,4711,-85
PSCO,"8/28/2022 12 p.m. MDT",5168,5189,5105,-63
PSCO,"8/28/2022 1 p.m. MDT",5564,5560,5576,12
PSCO,"8/28/2022 2 p.m. MDT",5839,5888,5649,-190
PSCO,"8/28/2022 3 p.m. MDT",5988,6243,5815,-173
PSCO,"8/28/2022 4 p.m. MDT",6204,6527,5874,-330
PSCO,"8/28/2022 5 p.m. MDT",6229,6599,5932,-297
PSCO,"8/28/2022 6 p.m. MDT",6006,6704,5789,-217
PSCO,"8/28/2022 7 p.m. MDT",5814,6576,5746,-68
PSCO,"8/28/2022 8 p.m. MDT",5651,6300,5408,-243
PSCO,"8/28/2022 9 p.m. MDT",5514,6112,5238,-276
PSCO,"8/28/2022 10 p.m. MDT",5194,5635,4941,-253
PSCO,"8/28/2022 11 p.m. MDT",4801,5151,4589,-212
PSCO,"8/29/2022 12 a.m. MDT",4392,4826,4136,-256
PSCO,"8/29/2022 1 a.m. MDT",4052,4380,3832,-220
PSCO,"8/29/2022 2 a.m. MDT",3947,4132,3763,-184
PSCO,"8/29/2022 3 a.m. MDT",3907,3996,3748,-159
PSCO,"8/29/2022 4 a.m. MDT",3847,3945,3740,-107
PSCO,"8/29/2022 5 a.m. MDT",3869,3965,3780,-89
PSCO,"8/29/2022 6 a.m. MDT",4055,4121,4029,-26
PSCO,"8/29/2022 7 a.m. MDT",4314,4369,4289,-25
PSCO,"8/29/2022 8 a.m. MDT",4443,4551,4552,109
PSCO,"8/29/2022 9 a.m. MDT",4678,4682,4658,-20
PSCO,"8/29/2022 10 a.m. MDT",4866,4896,4800,-66
PSCO,"8/29/2022 11 a.m. MDT",5062,5101,5034,-28
PSCO,"8/29/2022 12 p.m. MDT",5276,5325,5204,-72
PSCO,"8/29/2022 1 p.m. MDT",5461,5625,5463,2
PSCO,"8/29/2022 2 p.m. MDT",5757,5997,5965,208
PSCO,"8/29/2022 3 p.m. MDT",6208,6317,6332,124
PSCO,"8/29/2022 4 p.m. MDT",6507,6642,6530,23
PSCO,"8/29/2022 5 p.m. MDT",6894,6994,6837,-57
PSCO,"8/29/2022 6 p.m. MDT",7109,7025,7105,-4
PSCO,"8/29/2022 7 p.m. MDT",6991,6802,6852,-139
PSCO,"8/29/2022 8 p.m. MDT",6726,6559,6692,-34
PSCO,"8/29/2022 9 p.m. MDT",6412,6318,6339,-73
PSCO,"8/29/2022 10 p.m. MDT",5885,5868,5875,-10
PSCO,"8/29/2022 11 p.m. MDT",5360,5290,5372,12
PSCO,"8/30/2022 12 a.m. MDT",4961,4866,4978,17
PSCO,"8/30/2022 1 a.m. MDT",4586,4597,4663,77
PSCO,"8/30/2022 2 a.m. MDT",4338,4376,4439,101
PSCO,"8/30/2022 3 a.m. MDT",4166,4194,4137,-29
PSCO,"8/30/2022 4 a.m. MDT",4062,4099,4026,-36
PSCO,"8/30/2022 5 a.m. MDT",4062,4111,4036,-26
PSCO,"8/30/2022 6 a.m. MDT",4136,4276,4112,-24
PSCO,"8/30/2022 7 a.m. MDT",4425,4550,4328,-97
PSCO,"8/30/2022 8 a.m. MDT",4565,4722,4477,-88
PSCO,"8/30/2022 9 a.m. MDT",4732,4844,4719,-13
PSCO,"8/30/2022 10 a.m. MDT",4914,5106,4889,-25
PSCO,"8/30/2022 11 a.m. MDT",5229,5335,5180,-49
PSCO,"8/30/2022 12 p.m. MDT",5554,5646,5497,-57
PSCO,"8/30/2022 1 p.m. MDT",5992,6006,5982,-10
PSCO,"8/30/2022 2 p.m. MDT",6445,6450,6387,-58
PSCO,"8/30/2022 3 p.m. MDT",6792,6858,6767,-25
PSCO,"8/30/2022 4 p.m. MDT",7179,7211,7051,-128
PSCO,"8/30/2022 5 p.m. MDT",7391,7541,7257,-134
PSCO,"8/30/2022 6 p.m. MDT",7535,7632,7331,-204
PSCO,"8/30/2022 7 p.m. MDT",7466,7394,7256,-210
PSCO,"8/30/2022 8 p.m. MDT",7137,7136,7013,-124
PSCO,"8/30/2022 9 p.m. MDT",6965,6865,7070,105
PSCO,"8/30/2022 10 p.m. MDT",6418,6296,6682,264
PSCO,"8/30/2022 11 p.m. MDT",5776,5699,6056,280
PSCO,"8/31/2022 12 a.m. MDT",5383,5217,5578,195
PSCO,"8/31/2022 1 a.m. MDT",5154,4895,5367,213
PSCO,"8/31/2022 2 a.m. MDT",4836,4663,5032,196
PSCO,"8/31/2022 3 a.m. MDT",4617,4432,4986,369
PSCO,"8/31/2022 4 a.m. MDT",4465,4319,4854,389
PSCO,"8/31/2022 5 a.m. MDT",4448,4336,4784,336
PSCO,"8/31/2022 6 a.m. MDT",4561,4478,4973,412
PSCO,"8/31/2022 7 a.m. MDT",4703,4724,5175,472
PSCO,"8/31/2022 8 a.m. MDT",4835,4843,5038,203
PSCO,"8/31/2022 9 a.m. MDT",4978,5002,5068,90
PSCO,"8/31/2022 10 a.m. MDT",5253,5287,5303,50
PSCO,"8/31/2022 11 a.m. MDT",5568,5598,5555,-13
PSCO,"8/31/2022 12 p.m. MDT",5869,5947,5838,-31
PSCO,"8/31/2022 1 p.m. MDT",6252,6291,6279,27
PSCO,"8/31/2022 2 p.m. MDT",6641,6693,6721,80
PSCO,"8/31/2022 3 p.m. MDT",7026,7025,6961,-65
PSCO,"8/31/2022 4 p.m. MDT",7217,7327,7143,-74
PSCO,"8/31/2022 5 p.m. MDT",7271,7429,7194,-77
PSCO,"8/31/2022 6 p.m. MDT",7031,7382,7001,-30
PSCO,"8/31/2022 7 p.m. MDT",6844,7024,6851,7
PSCO,"8/31/2022 8 p.m. MDT",6587,6649,6731,144
PSCO,"8/31/2022 9 p.m. MDT",6319,6515,6343,24
PSCO,"8/31/2022 10 p.m. MDT",5856,6138,5984,128
PSCO,"8/31/2022 11 p.m. MDT",5308,5543,5294,-14
PSCO,"9/1/2022 12 a.m. MDT",4900,5038,4831,-69
