"BA Code","Timestamp (Hour Ending)","Demand (MWh)","Demand Forecast (MWh)","Net Generation (MWh)","Total Interchange (MWh)"
PSCO,"12/1/2022 12 a.m. MST",4981,4887,5353,372
PSCO,"12/1/2022 1 a.m. MST",4786,4690,5317,531
PSCO,"12/1/2022 2 a.m. MST",4686,4578,5221,535
PSCO,"12/1/2022 3 a.m. MST",4661,4552,5117,456
PSCO,"12/1/2022 4 a.m. MST",4655,4608,5176,521
PSCO,"12/1/2022 5 a.m. MST",4768,4727,5279,511
PSCO,"12/1/2022 6 a.m. MST",5012,5005,5295,283
PSCO,"12/1/2022 7 a.m. MST",5342,5512,5549,207
PSCO,"12/1/2022 8 a.m. MST",5433,5618,5780,347
PSCO,"12/1/2022 9 a.m. MST",5279,5386,5668,389
PSCO,"12/1/2022 10 a.m. MST",5098,5076,5541,443
PSCO,"12/1/2022 11 a.m. MST",4943,4905,5454,511
PSCO,"12/1/2022 12 p.m. MST",4810,4792,5229,419
PSCO,"12/1/2022 1 p.m. MST",4713,4752,5133,420
PSCO,"12/1/2022 2 p.m. MST",4783,4705,5251,468
PSCO,"12/1/2022 3 p.m. MST",4856,4749,5164,308
PSCO,"12/1/2022 4 p.m. MST",5046,4870,5330,284
PSCO,"12/1/2022 5 p.m. MST",5327,5231,5573,246
PSCO,"12/1/2022 6 p.m. MST",5616,5619,6002,386
PSCO,"12/1/2022 7 p.m. MST",5532,5569,6015,483
PSCO,"12/1/2022 8 p.m. MST",5325,5445,5845,520
PSCO,"12/1/2022 9 p.m. MST",5164,5325,5553,389
PSCO,"12/1/2022 10 p.m. MST",4947,5141,5342,395
PSCO,"12/1/2022 11 p.m. MST",4655,4862,5151,496
PSCO,"12/2/2022 12 a.m. MST",4432,4630,4802,370
PSCO,"12/2/2022 1 a.m. MST",4227,4454,4716,489
PSCO,"12/2/2022 2 a.m. MST",4084,4222,4699,615
PSCO,"12/2/2022 3 a.m. MST",4054,4342,4652,598
PSCO,"12/2/2022 4 a.m. MST",4134,4372,4629,495
PSCO,"12/2/2022 5 a.m. MST",4162,4516,4544,382
PSCO,"12/2/2022 6 a.m. MST",4393,4719,4671,278
PSCO,"12/2/2022 7 a.m. MST",4737,5164,4929,192
PSCO,"12/2/2022 8 a.m. MST",4939,5280,5254,315
PSCO,"12/2/2022 9 a.m. MST",4801,5174,5047,246
PSCO,"12/2/2022 10 a.m. MST",4741,5026,4916,175
PSCO,"12/2/2022 11 a.m. MST",4818,4898,5008,190
PSCO,"12/2/2022 12 p.m. MST",4783,4817,5023,240
PSCO,"12/2/2022 1 p.m. MST",4740,4752,4993,253
PSCO,"12/2/2022 2 p.m. MST",4735,4803,4979,244
PSCO,"12/2/2022 3 p.m. MST",4781,4841,5063,282
PSCO,"12/2/2022 4 p.m. MST",4974,4963,5120,146
PSCO,"12/2/2022 5 p.m. MST",5352,5381,5466,114
PSCO,"12/2/2022 6 p.m. MST",5654,5724,5879,225
PSCO,"12/2/2022 7 p.m. MST",5549,5610,5815,266
PSCO,"12/2/2022 8 p.m. MST",5445,5467,5897,452
PSCO,"12/2/2022 9 p.m. MST",5406,5347,5862,456
PSCO,"12/2/2022 10 p.m. MST",5514,5214,6041,527
PSCO,"12/2/2022 11 p.m. MST",5860,4996,6242,382
PSCO,"12/3/2022 12 a.m. MST",5083,4876,5597,514
PSCO,"12/3/2022 1 a.m. MST",4460,4713,4962,502
PSCO,"12/3/2022 2 a.m. MST",4444,4569,4961,517
PSCO,"12/3/2022 3 a.m. MST",4411,4552,4936,525
PSCO,"12/3/2022 4 a.m. MST",4439,4537,4889,450
PSCO,"12/3/2022 5 a.m. MST",4487,4613,5004,517
PSCO,"12/3/2022 6 a.m. MST",4651,4734,5097,446
PSCO,"12/3/2022 7 a.m. MST",4907,4943,5350,443
PSCO,"12/3/2022 8 a.m. MST",4997,4988,5650,653
PSCO,"12/3/2022 9 a.m. MST",4976,4965,5591,615
PSCO,"12/3/2022 10 a.m. MST",4858,4941,5584,726
PSCO,"12/3/2022 11 a.m. MST",4765,4871,5424,659
PSCO,"12/3/2022 12 p.m. MST",4688,4754,5263,575
PSCO,"12/3/2022 1 p.m. MST",4662,4675,5279,617
PSCO,"12/3/2022 2 p.m. MST",4627,4660,5255,628
PSCO,"12/3/2022 3 p.m. MST",4654,4691,5137,483
PSCO,"12/3/2022 4 p.m. MST",4840,4899,5088,248
PSCO,"12/3/2022 5 p.m. MST",5135,5275,5445,310
PSCO,"12/3/2022 6 p.m. MST",5397,5668,5805,408
PSCO,"12/3/2022 7 p.m. MST",5315,5596,5733,418
PSCO,"12/3/2022 8 p.m. MST",5181,5482,5621,440
PSCO,"12/3/2022 9 p.m. MST",5061,5407,5558,497
PSCO,"12/3/2022 10 p.m. MST",4913,5223,5442,529
PSCO,"12/3/2022 11 p.m. MST",4673,5030,5176,503
PSCO,"12/4/2022 12 a.m. MST",4454,4755,5002,548
PSCO,"12/4/2022 1 a.m. MST",4316,4608,5018,702
PSCO,"12/4/2022 2 a.m. MST",4191,4520,5114,923
PSCO,"12/4/2022 3 a.m. MST",4236,4448,4894,658
PSCO,"12/4/2022 4 a.m. MST",4136,4458,4861,725
PSCO,"12/4/2022 5 a.m. MST",4166,4468,4723,557
PSCO,"12/4/2022 6 a.m. MST",4254,4559,4615,361
PSCO,"12/4/2022 7 a.m. MST",4446,4741,4811,365
PSCO,"12/4/2022 8 a.m. MST",4571,4898,4985,414
PSCO,"12/4/2022 9 a.m. MST",4580,4737,5002,422
PSCO,"12/4/2022 10 a.m. MST",4451,4570,4922,471
PSCO,"12/4/2022 11 a.m. MST",4446,4470,4985,539
PSCO,"12/4/2022 12 p.m. MST",4404,4441,4987,583
PSCO,"12/4/2022 1 p.m. MST",4381,4388,4903,522
PSCO,"12/4/2022 2 p.m. MST",4378,4411,4866,488
PSCO,"12/4/2022 3 p.m. MST",4459,4469,4851,392
PSCO,"12/4/2022 4 p.m. MST",4600,4608,4998,398
PSCO,"12/4/2022 5 p.m. MST",4949,5079,5449,500
PSCO,"12/4/2022 6 p.m. MST",5365,5552,5891,526
PSCO,"12/4/2022 7 p.m. MST",5362,5579,5839,477
PSCO,"12/4/2022 8 p.m. MST",5320,5420,5465,145
PSCO,"12/4/2022 9 p.m. MST",5128,5294,5302,174
PSCO,"12/4/2022 10 p.m. MST",4856,5102,5129,273
PSCO,"12/4/2022 11 p.m. MST",4552,4815,4730,178
PSCO,"12/5/2022 12 a.m. MST",4215,4465,4401,186
PSCO,"12/5/2022 1 a.m. MST",4063,4342,4363,300
PSCO,"12/5/2022 2 a.m. MST",3979,4256,4202,223
PSCO,"12/5/2022 3 a.m. MST",3994,4259,4259,265
PSCO,"12/5/2022 4 a.m. MST",4026,4265,4308,282
PSCO,"12/5/2022 5 a.m. MST",4107,4377,4486,379
PSCO,"12/5/2022 6 a.m. MST",4373,4643,4670,297
PSCO,"12/5/2022 7 a.m. MST",4798,5127,5037,239
PSCO,"12/5/2022 8 a.m. MST",5033,5328,5323,290
PSCO,"12/5/2022 9 a.m. MST",4931,5311,5227,296
PSCO,"12/5/2022 10 a.m. MST",4784,5168,5018,234
PSCO,"12/5/2022 11 a.m. MST",4741,5125,5018,277
PSCO,"12/5/2022 12 p.m. MST",4683,5099,4857,174
PSCO,"12/5/2022 1 p.m. MST",4689,5032,4786,97
PSCO,"12/5/2022 2 p.m. MST",4688,5008,4712,24
PSCO,"12/5/2022 3 p.m. MST",4726,5021,4723,-3
PSCO,"12/5/2022 4 p.m. MST",4919,5134,5012,93
PSCO,"12/5/2022 5 p.m. MST",5227,5373,5201,-26
PSCO,"12/5/2022 6 p.m. MST",5548,5685,5794,246
PSCO,"12/5/2022 7 p.m. MST",5515,5640,5800,285
PSCO,"12/5/2022 8 p.m. MST",5401,5546,5655,254
PSCO,"12/5/2022 9 p.m. MST",5266,5376,5528,262
PSCO,"12/5/2022 10 p.m. MST",5016,5154,5396,380
PSCO,"12/5/2022 11 p.m. MST",4655,4818,4826,171
PSCO,"12/6/2022 12 a.m. MST",4375,4624,4631,256
PSCO,"12/6/2022 1 a.m. MST",4276,4476,4670,394
PSCO,"12/6/2022 2 a.m. MST",4273,4405,4669,396
PSCO,"12/6/2022 3 a.m. MST",4256,4380,4673,417
PSCO,"12/6/2022 4 a.m. MST",4305,4405,4681,376
PSCO,"12/6/2022 5 a.m. MST",4412,4473,4841,429
PSCO,"12/6/2022 6 a.m. MST",4722,4732,5053,331
PSCO,"12/6/2022 7 a.m. MST",5168,5217,5385,217
PSCO,"12/6/2022 8 a.m. MST",5337,5399,5571,234
PSCO,"12/6/2022 9 a.m. MST",5196,5283,5493,297
PSCO,"12/6/2022 10 a.m. MST",5078,4987,5260,182
PSCO,"12/6/2022 11 a.m. MST",4969,4871,5257,288
PSCO,"12/6/2022 12 p.m. MST",4861,4789,5163,302
PSCO,"12/6/2022 1 p.m. MST",4823,4740,5035,212
PSCO,"12/6/2022 2 p.m. MST",4835,4701,5036,201
PSCO,"12/6/2022 3 p.m. MST",4898,4767,4966,68
PSCO,"12/6/2022 4 p.m. MST",5055,5041,5106,51
PSCO,"12/6/2022 5 p.m. MST",5383,5395,5543,160
PSCO,"12/6/2022 6 p.m. MST",5702,5733,6006,304
PSCO,"12/6/2022 7 p.m. MST",5608,5627,5923,315
PSCO,"12/6/2022 8 p.m. MST",5492,5522,5845,353
PSCO,"12/6/2022 9 p.m. MST",5359,5392,5631,272
PSCO,"12/6/2022 10 p.m. MST",5161,5171,5501,340
PSCO,"12/6/2022 11 p.m. MST",4873,4822,5144,271
PSCO,"12/7/2022 12 a.m. MST",4592,4629,4851,259
PSCO,"12/7/2022 1 a.m. MST",4409,4492,4758,349
PSCO,"12/7/2022 2 a.m. MST",4294,4402,4631,337
PSCO,"12/7/2022 3 a.m. MST",4242,4364,4650,408
PSCO,"12/7/2022 4 a.m. MST",4321,4382,4717,396
PSCO,"12/7/2022 5 a.m. MST",4456,4510,4898,442
PSCO,"12/7/2022 6 a.m. MST",4738,4789,5103,365
PSCO,"12/7/2022 7 a.m. MST",5143,5269,5506,363
PSCO,"12/7/2022 8 a.m. MST",5332,5423,5660,328
PSCO,"12/7/2022 9 a.m. MST",5176,5199,5515,339
PSCO,"12/7/2022 10 a.m. MST",5007,5013,5254,247
PSCO,"12/7/2022 11 a.m. MST",4850,4888,5095,245
PSCO,"12/7/2022 12 p.m. MST",4739,4805,4925,186
PSCO,"12/7/2022 1 p.m. MST",4696,4750,4950,254
PSCO,"12/7/2022 2 p.m. MST",4754,4735,4931,177
PSCO,"12/7/2022 3 p.m. MST",4901,4824,5020,119
PSCO,"12/7/2022 4 p.m. MST",5105,4943,5177,72
PSCO,"12/7/2022 5 p.m. MST",5462,5331,5704,242
PSCO,"12/7/2022 6 p.m. MST",5828,5732,5976,148
PSCO,"12/7/2022 7 p.m. MST",5689,5667,5947,258
PSCO,"12/7/2022 8 p.m. MST",5587,5554,5983,396
PSCO,"12/7/2022 9 p.m. MST",5444,5427,5827,383
PSCO,"12/7/2022 10 p.m. MST",5242,5210,5683,441
PSCO,"12/7/2022 11 p.m. MST",4917,4871,5175,258
PSCO,"12/8/2022 12 a.m. MST",4606,4650,5004,398
PSCO,"12/8/2022 1 a.m. MST",4467,4456,5103,636
PSCO,"12/8/2022 2 a.m. MST",4395,4364,5017,622
PSCO,"12/8/2022 3 a.m. MST",4407,4341,5005,598
PSCO,"12/8/2022 4 a.m. MST",4462,4364,5024,562
PSCO,"12/8/2022 5 a.m. MST",4539,4510,5154,615
PSCO,"12/8/2022 6 a.m. MST",4801,4795,5463,662
PSCO,"12/8/2022 7 a.m. MST",5230,5290,6021,791
PSCO,"12/8/2022 8 a.m. MST",5444,5477,6219,775
PSCO,"12/8/2022 9 a.m. MST",5215,5404,6061,846
PSCO,"12/8/2022 10 a.m. MST",5026,5134,5892,866
PSCO,"12/8/2022 11 a.m. MST",4849,4921,5787,938
PSCO,"12/8/2022 12 p.m. MST",4809,4829,5662,853
PSCO,"12/8/2022 1 p.m. MST",4753,4786,5442,689
PSCO,"12/8/2022 2 p.m. MST",4848,4806,5678,830
PSCO,"12/8/2022 3 p.m. MST",4875,4902,5515,640
PSCO,"12/8/2022 4 p.m. MST",5033,5000,5795,762
PSCO,"12/8/2022 5 p.m. MST",5427,5392,6305,878
PSCO,"12/8/2022 6 p.m. MST",5807,5721,6602,795
PSCO,"12/8/2022 7 p.m. MST",5773,5665,6389,616
PSCO,"12/8/2022 8 p.m. MST",5661,5548,6270,609
PSCO,"12/8/2022 9 p.m. MST",5568,5445,6114,546
PSCO,"12/8/2022 10 p.m. MST",5354,5257,5725,371
PSCO,"12/8/2022 11 p.m. MST",5049,4953,5489,440
PSCO,"12/9/2022 12 a.m. MST",4771,4740,5273,502
PSCO,"12/9/2022 1 a.m. MST",4637,4594,5110,473
PSCO,"12/9/2022 2 a.m. MST",4598,4522,5157,559
PSCO,"12/9/2022 3 a.m. MST",4560,4508,5116,556
PSCO,"12/9/2022 4 a.m. MST",4631,4543,5228,597
PSCO,"12/9/2022 5 a.m. MST",4758,4669,5400,642
PSCO,"12/9/2022 6 a.m. MST",5051,4963,5558,507
PSCO,"12/9/2022 7 a.m. MST",5430,5383,5956,526
PSCO,"12/9/2022 8 a.m. MST",5651,5553,6321,670
PSCO,"12/9/2022 9 a.m. MST",5483,5390,6098,615
PSCO,"12/9/2022 10 a.m. MST",5273,5251,5900,627
PSCO,"12/9/2022 11 a.m. MST",5118,5070,5830,712
PSCO,"12/9/2022 12 p.m. MST",4997,4918,5511,514
PSCO,"12/9/2022 1 p.m. MST",4892,4838,5388,496
PSCO,"12/9/2022 2 p.m. MST",4854,4799,5382,528
PSCO,"12/9/2022 3 p.m. MST",4870,4872,5387,517
PSCO,"12/9/2022 4 p.m. MST",5082,5015,5530,448
PSCO,"12/9/2022 5 p.m. MST",5431,5437,5831,400
PSCO,"12/9/2022 6 p.m. MST",5735,5739,6277,542
PSCO,"12/9/2022 7 p.m. MST",5649,5643,6164,515
PSCO,"12/9/2022 8 p.m. MST",5518,5480,6223,705
PSCO,"12/9/2022 9 p.m. MST",5381,5405,5758,377
PSCO,"12/9/2022 10 p.m. MST",5240,5242,5716,476
PSCO,"12/9/2022 11 p.m. MST",5016,4980,5477,461
PSCO,"12/10/2022 12 a.m. MST",4735,4840,5236,501
PSCO,"12/10/2022 1 a.m. MST",4574,4564,4968,394
PSCO,"12/10/2022 2 a.m. MST",4480,4441,4689,209
PSCO,"12/10/2022 3 a.m. MST",4408,4386,4485,77
PSCO,"12/10/2022 4 a.m. MST",4404,4416,4584,180
PSCO,"12/10/2022 5 a.m. MST",4453,4397,4615,162
PSCO,"12/10/2022 6 a.m. MST",4620,4586,4849,229
PSCO,"12/10/2022 7 a.m. MST",4852,4848,5155,303
PSCO,"12/10/2022 8 a.m. MST",4986,4949,5137,151
PSCO,"12/10/2022 9 a.m. MST",4859,4852,4966,107
PSCO,"12/10/2022 10 a.m. MST",4709,4749,5090,381
PSCO,"12/10/2022 11 a.m. MST",4639,4624,4990,351
PSCO,"12/10/2022 12 p.m. MST",4519,4532,4952,433
PSCO,"12/10/2022 1 p.m. MST",4522,4385,4969,447
PSCO,"12/10/2022 2 p.m. MST",4500,4333,4817,317
PSCO,"12/10/2022 3 p.m. MST",4495,4357,4762,267
PSCO,"12/10/2022 4 p.m. MST",4689,4585,5061,372
PSCO,"12/10/2022 5 p.m. MST",5074,4993,5400,326
PSCO,"12/10/2022 6 p.m. MST",5405,5467,5810,405
PSCO,"12/10/2022 7 p.m. MST",5382,5440,5865,483
PSCO,"12/10/2022 8 p.m. MST",5256,5330,5665,409
PSCO,"12/10/2022 9 p.m. MST",5160,5194,5609,449
PSCO,"12/10/2022 10 p.m. MST",5059,5065,5421,362
PSCO,"12/10/2022 11 p.m. MST",4805,4854,5321,516
PSCO,"12/11/2022 12 a.m. MST",4604,4648,5025,421
PSCO,"12/11/2022 1 a.m. MST",4499,4497,4897,398
PSCO,"12/11/2022 2 a.m. MST",4463,4454,4853,390
PSCO,"12/11/2022 3 a.m. MST",4377,4398,4705,328
PSCO,"12/11/2022 4 a.m. MST",4309,4335,4621,312
PSCO,"12/11/2022 5 a.m. MST",4327,4403,4455,128
PSCO,"12/11/2022 6 a.m. MST",4421,4401,4563,142
PSCO,"12/11/2022 7 a.m. MST",4598,4647,4772,174
PSCO,"12/11/2022 8 a.m. MST",4621,4781,4928,307
PSCO,"12/11/2022 9 a.m. MST",4595,4663,4981,386
PSCO,"12/11/2022 10 a.m. MST",4488,4507,4879,391
PSCO,"12/11/2022 11 a.m. MST",4432,4469,4907,475
PSCO,"12/11/2022 12 p.m. MST",4383,4445,4677,294
PSCO,"12/11/2022 1 p.m. MST",4352,4345,4582,230
PSCO,"12/11/2022 2 p.m. MST",4372,4321,4646,274
PSCO,"12/11/2022 3 p.m. MST",4453,4477,4734,281
PSCO,"12/11/2022 4 p.m. MST",4648,4624,4872,224
PSCO,"12/11/2022 5 p.m. MST",4998,5097,5182,184
PSCO,"12/11/2022 6 p.m. MST",5371,5445,5462,91
PSCO,"12/11/2022 7 p.m. MST",5344,5406,5455,111
PSCO,"12/11/2022 8 p.m. MST",5276,5315,5405,129
PSCO,"12/11/2022 9 p.m. MST",5147,5245,5296,149
PSCO,"12/11/2022 10 p.m. MST",4960,5043,5141,181
PSCO,"12/11/2022 11 p.m. MST",4602,4803,4874,272
PSCO,"12/12/2022 12 a.m. MST",4457,4436,4622,165
PSCO,"12/12/2022 1 a.m. MST",4304,4307,4396,92
PSCO,"12/12/2022 2 a.m. MST",4192,4251,4265,73
PSCO,"12/12/2022 3 a.m. MST",4198,4182,4307,109
PSCO,"12/12/2022 4 a.m. MST",4214,4228,4322,108
PSCO,"12/12/2022 5 a.m. MST",4234,4362,4355,121
PSCO,"12/12/2022 6 a.m. MST",4577,4616,4765,188
PSCO,"12/12/2022 7 a.m. MST",4989,5106,5181,192
PSCO,"12/12/2022 8 a.m. MST",5169,5268,5507,338
PSCO,"12/12/2022 9 a.m. MST",5201,5222,5492,291
PSCO,"12/12/2022 10 a.m. MST",5124,5012,5510,386
PSCO,"12/12/2022 11 a.m. MST",5067,4910,5535,468
PSCO,"12/12/2022 12 p.m. MST",5054,4817,5607,553
PSCO,"12/12/2022 1 p.m. MST",4951,4757,5586,635
PSCO,"12/12/2022 2 p.m. MST",4907,4767,5543,636
PSCO,"12/12/2022 3 p.m. MST",5009,5053,5691,682
PSCO,"12/12/2022 4 p.m. MST",5156,5263,5843,687
PSCO,"12/12/2022 5 p.m. MST",5458,5484,6042,584
PSCO,"12/12/2022 6 p.m. MST",5822,5832,6310,488
PSCO,"12/12/2022 7 p.m. MST",5798,5753,6352,554
PSCO,"12/12/2022 8 p.m. MST",5723,5657,6203,480
PSCO,"12/12/2022 9 p.m. MST",5595,5521,6038,443
PSCO,"12/12/2022 10 p.m. MST",5397,5296,5911,514
PSCO,"12/12/2022 11 p.m. MST",5029,4949,5457,428
PSCO,"12/13/2022 12 a.m. MST",4851,4695,5268,417
PSCO,"12/13/2022 1 a.m. MST",4666,4523,5017,351
PSCO,"12/13/2022 2 a.m. MST",4583,4467,4992,409
PSCO,"12/13/2022 3 a.m. MST",4557,4478,4887,330
PSCO,"12/13/2022 4 a.m. MST",4568,4529,4837,269
PSCO,"12/13/2022 5 a.m. MST",4722,4648,5003,281
PSCO,"12/13/2022 6 a.m. MST",5013,4828,5291,278
PSCO,"12/13/2022 7 a.m. MST",5382,5220,5722,340
PSCO,"12/13/2022 8 a.m. MST",5593,5459,6120,527
PSCO,"12/13/2022 9 a.m. MST",5643,5478,6131,488
PSCO,"12/13/2022 10 a.m. MST",5727,5550,6142,415
PSCO,"12/13/2022 11 a.m. MST",5743,5550,6151,408
PSCO,"12/13/2022 12 p.m. MST",5795,5546,5950,155
PSCO,"12/13/2022 1 p.m. MST",5749,5493,5809,60
PSCO,"12/13/2022 2 p.m. MST",5792,5458,5823,31
PSCO,"12/13/2022 3 p.m. MST",5711,5457,5755,44
PSCO,"12/13/2022 4 p.m. MST",5755,5532,6035,280
PSCO,"12/13/2022 5 p.m. MST",6076,5819,6372,296
PSCO,"12/13/2022 6 p.m. MST",6331,6130,6653,322
PSCO,"12/13/2022 7 p.m. MST",6235,6016,6736,501
PSCO,"12/13/2022 8 p.m. MST",6119,5893,6606,487
PSCO,"12/13/2022 9 p.m. MST",5946,5710,6490,544
PSCO,"12/13/2022 10 p.m. MST",5671,5477,6176,505
PSCO,"12/13/2022 11 p.m. MST",5329,5104,5861,532
PSCO,"12/14/2022 12 a.m. MST",5091,4860,5738,647
PSCO,"12/14/2022 1 a.m. MST",4920,4680,5359,439
PSCO,"12/14/2022 2 a.m. MST",4792,4631,5336,544
PSCO,"12/14/2022 3 a.m. MST",4799,4610,5408,609
PSCO,"12/14/2022 4 a.m. MST",4826,4637,5454,628
PSCO,"12/14/2022 5 a.m. MST",4950,4733,5571,621
PSCO,"12/14/2022 6 a.m. MST",5244,4978,5908,664
PSCO,"12/14/2022 7 a.m. MST",5641,5348,6120,479
PSCO,"12/14/2022 8 a.m. MST",5838,5556,6293,455
PSCO,"12/14/2022 9 a.m. MST",5755,5531,6108,353
PSCO,"12/14/2022 10 a.m. MST",5627,5605,5911,284
PSCO,"12/14/2022 11 a.m. MST",5478,5587,5697,219
PSCO,"12/14/2022 12 p.m. MST",5398,5567,5646,248
PSCO,"12/14/2022 1 p.m. MST",5387,5524,5697,310
PSCO,"12/14/2022 2 p.m. MST",5331,5464,5635,304
PSCO,"12/14/2022 3 p.m. MST",5398,5409,5629,231
PSCO,"12/14/2022 4 p.m. MST",5544,5467,5882,338
PSCO,"12/14/2022 5 p.m. MST",5813,5763,6204,391
PSCO,"12/14/2022 6 p.m. MST",6233,6081,6615,382
PSCO,"12/14/2022 7 p.m. MST",6175,5960,6589,414
PSCO,"12/14/2022 8 p.m. MST",6017,5858,6427,410
PSCO,"12/14/2022 9 p.m. MST",5905,5670,6289,384
PSCO,"12/14/2022 10 p.m. MST",5651,5458,5978,327
PSCO,"12/14/2022 11 p.m. MST",5312,5104,5689,377
PSCO,"12/15/2022 12 a.m. MST",5090,4906,5554,464
PSCO,"12/15/2022 1 a.m. MST",4940,4767,5283,343
PSCO,"12/15/2022 2 a.m. MST",4857,4697,5199,342
PSCO,"12/15/2022 3 a.m. MST",4813,4622,5162,349
PSCO,"12/15/2022 4 a.m. MST",4857,4668,5189,332
PSCO,"12/15/2022 5 a.m. MST",5007,4779,5333,326
PSCO,"12/15/2022 6 a.m. MST",5231,5069,5554,323
PSCO,"12/15/2022 7 a.m. MST",5627,5448,6055,428
PSCO,"12/15/2022 8 a.m. MST",5841,5682,6197,356
PSCO,"12/15/2022 9 a.m. MST",5895,5538,6243,348
PSCO,"12/15/2022 10 a.m. MST",5822,5343,6060,238
PSCO,"12/15/2022 11 a.m. MST",5547,5283,5804,257
PSCO,"12/15/2022 12 p.m. MST",5576,5228,5764,188
PSCO,"12/15/2022 1 p.m. MST",5639,5226,5929,290
PSCO,"12/15/2022 2 p.m. MST",5620,5221,5897,277
PSCO,"12/15/2022 3 p.m. MST",5587,5261,5844,257
PSCO,"12/15/2022 4 p.m. MST",5690,5414,5895,205
PSCO,"12/15/2022 5 p.m. MST",6021,5761,6350,329
PSCO,"12/15/2022 6 p.m. MST",6343,6116,6680,337
PSCO,"12/15/2022 7 p.m. MST",6223,6013,6597,374
PSCO,"12/15/2022 8 p.m. MST",6143,5940,6614,471
PSCO,"12/15/2022 9 p.m. MST",6008,5814,6410,402
PSCO,"12/15/2022 10 p.m. MST",5794,5598,6170,376
PSCO,"12/15/2022 11 p.m. MST",5438,5260,5945,507
PSCO,"12/16/2022 12 a.m. MST",5223,4859,5641,418
PSCO,"12/16/2022 1 a.m. MST",5061,4697,5433,372
PSCO,"12/16/2022 2 a.m. MST",4978,4683,5487,509
PSCO,"12/16/2022 3 a.m. MST",4921,4667,5453,532
PSCO,"12/16/2022 4 a.m. MST",4967,4737,5460,493
PSCO,"12/16/2022 5 a.m. MST",5097,4839,5581,484
PSCO,"12/16/2022 6 a.m. MST",5356,5135,5762,406
PSCO,"12/16/2022 7 a.m. MST",5748,5526,6127,379
PSCO,"12/16/2022 8 a.m. MST",5870,5726,6160,290
PSCO,"12/16/2022 9 a.m. MST",5804,5594,6318,514
PSCO,"12/16/2022 10 a.m. MST",5652,5497,5941,289
PSCO,"12/16/2022 11 a.m. MST",5455,5334,5722,267
PSCO,"12/16/2022 12 p.m. MST",5336,5191,5624,288
PSCO,"12/16/2022 1 p.m. MST",5303,5167,5595,292
PSCO,"12/16/2022 2 p.m. MST",5268,5141,5521,253
PSCO,"12/16/2022 3 p.m. MST",5272,5183,5542,270
PSCO,"12/16/2022 4 p.m. MST",5455,5286,5631,176
PSCO,"12/16/2022 5 p.m. MST",5844,5642,6085,241
PSCO,"12/16/2022 6 p.m. MST",6212,6026,6483,271
PSCO,"12/16/2022 7 p.m. MST",6040,5943,6291,251
PSCO,"12/16/2022 8 p.m. MST",5988,5814,6188,200
PSCO,"12/16/2022 9 p.m. MST",5861,5717,6092,231
PSCO,"12/16/2022 10 p.m. MST",5648,5577,5866,218
PSCO,"12/16/2022 11 p.m. MST",5442,5352,5695,253
PSCO,"12/17/2022 12 a.m. MST",5242,5083,5583,341
PSCO,"12/17/2022 1 a.m. MST",5069,4869,5572,503
PSCO,"12/17/2022 2 a.m. MST",4967,4758,5343,376
PSCO,"12/17/2022 3 a.m. MST",4918,4717,5296,378
PSCO,"12/17/2022 4 a.m. MST",4906,4692,5341,435
PSCO,"12/17/2022 5 a.m. MST",4953,4771,5402,449
PSCO,"12/17/2022 6 a.m. MST",5096,4862,5560,464
PSCO,"12/17/2022 7 a.m. MST",5257,5100,5717,460
PSCO,"12/17/2022 8 a.m. MST",5317,5209,5936,619
PSCO,"12/17/2022 9 a.m. MST",5258,5153,5811,553
PSCO,"12/17/2022 10 a.m. MST",5149,5046,5736,587
PSCO,"12/17/2022 11 a.m. MST",5021,4987,5379,358
PSCO,"12/17/2022 12 p.m. MST",4926,4832,5295,369
PSCO,"12/17/2022 1 p.m. MST",4776,4749,4993,217
PSCO,"12/17/2022 2 p.m. MST",4759,4651,4976,217
PSCO,"12/17/2022 3 p.m. MST",4830,4619,4955,125
PSCO,"12/17/2022 4 p.m. MST",5069,4819,5166,97
PSCO,"12/17/2022 5 p.m. MST",5506,5291,5753,247
PSCO,"12/17/2022 6 p.m. MST",5857,5748,6308,451
PSCO,"12/17/2022 7 p.m. MST",5835,5706,6470,635
PSCO,"12/17/2022 8 p.m. MST",5764,5610,6475,711
PSCO,"12/17/2022 9 p.m. MST",5712,5503,6477,765
PSCO,"12/17/2022 10 p.m. MST",5566,5379,6440,874
PSCO,"12/17/2022 11 p.m. MST",5338,5211,6073,735
PSCO,"12/18/2022 12 a.m. MST",5142,4922,5888,746
PSCO,"12/18/2022 1 a.m. MST",4941,4762,5729,788
PSCO,"12/18/2022 2 a.m. MST",4850,4768,5526,676
PSCO,"12/18/2022 3 a.m. MST",4786,4664,5505,719
PSCO,"12/18/2022 4 a.m. MST",4760,4614,5420,660
PSCO,"12/18/2022 5 a.m. MST",4812,4688,5239,427
PSCO,"12/18/2022 6 a.m. MST",4896,4668,5356,460
PSCO,"12/18/2022 7 a.m. MST",5072,4812,5443,371
PSCO,"12/18/2022 8 a.m. MST",5178,4924,5578,400
PSCO,"12/18/2022 9 a.m. MST",5147,4915,5559,412
PSCO,"12/18/2022 10 a.m. MST",5123,4789,5493,370
PSCO,"12/18/2022 11 a.m. MST",4956,4733,5176,220
PSCO,"12/18/2022 12 p.m. MST",4842,4633,5160,318
PSCO,"12/18/2022 1 p.m. MST",4808,4591,5206,398
PSCO,"12/18/2022 2 p.m. MST",4768,4686,5094,326
PSCO,"12/18/2022 3 p.m. MST",4775,4917,5106,331
PSCO,"12/18/2022 4 p.m. MST",4952,5058,5201,249
PSCO,"12/18/2022 5 p.m. MST",5394,5378,5668,274
PSCO,"12/18/2022 6 p.m. MST",5852,5606,6124,272
PSCO,"12/18/2022 7 p.m. MST",5848,5815,6164,316
PSCO,"12/18/2022 8 p.m. MST",5794,5632,6170,376
PSCO,"12/18/2022 9 p.m. MST",5718,5654,6176,458
PSCO,"12/18/2022 10 p.m. MST",5511,5431,5959,448
PSCO,"12/18/2022 11 p.m. MST",5213,5028,5743,530
PSCO,"12/19/2022 12 a.m. MST",4985,4776,5616,631
PSCO,"12/19/2022 1 a.m. MST",4780,4619,5419,639
PSCO,"12/19/2022 2 a.m. MST",4764,4751,5231,467
PSCO,"12/19/2022 3 a.m. MST",4808,4707,5214,406
PSCO,"12/19/2022 4 a.m. MST",4858,4745,5287,429
PSCO,"12/19/2022 5 a.m. MST",4989,4843,5382,393
PSCO,"12/19/2022 6 a.m. MST",5259,5079,5550,291
PSCO,"12/19/2022 7 a.m. MST",5533,5465,5776,243
PSCO,"12/19/2022 8 a.m. MST",5717,5659,6206,489
PSCO,"12/19/2022 9 a.m. MST",5791,5552,6222,431
PSCO,"12/19/2022 10 a.m. MST",5624,5373,6074,450
PSCO,"12/19/2022 11 a.m. MST",5376,5178,5771,395
PSCO,"12/19/2022 12 p.m. MST",5153,5029,5660,507
PSCO,"12/19/2022 1 p.m. MST",5147,5016,5647,500
PSCO,"12/19/2022 2 p.m. MST",5044,5015,5491,447
PSCO,"12/19/2022 3 p.m. MST",5077,5061,5493,416
PSCO,"12/19/2022 4 p.m. MST",5241,5217,5762,521
PSCO,"12/19/2022 5 p.m. MST",5576,5588,6122,546
PSCO,"12/19/2022 6 p.m. MST",5986,6044,6435,449
PSCO,"12/19/2022 7 p.m. MST",5944,6055,6478,534
PSCO,"12/19/2022 8 p.m. MST",5855,5962,6402,547
PSCO,"12/19/2022 9 p.m. MST",5738,5835,6341,603
PSCO,"12/19/2022 10 p.m. MST",5533,5638,6040,507
PSCO,"12/19/2022 11 p.m. MST",5227,5337,5783,556
PSCO,"12/20/2022 12 a.m. MST",4971,5030,5407,436
PSCO,"12/20/2022 1 a.m. MST",4818,4764,5343,525
PSCO,"12/20/2022 2 a.m. MST",4763,4633,5251,488
PSCO,"12/20/2022 3 a.m. MST",4722,4719,5195,473
PSCO,"12/20/2022 4 a.m. MST",4740,4699,5264,524
PSCO,"12/20/2022 5 a.m. MST",4909,4818,5362,453
PSCO,"12/20/2022 6 a.m. MST",5150,5080,5607,457
PSCO,"12/20/2022 7 a.m. MST",5504,5452,5930,426
PSCO,"12/20/2022 8 a.m. MST",5607,5696,6090,483
PSCO,"12/20/2022 9 a.m. MST",5530,5631,6098,568
PSCO,"12/20/2022 10 a.m. MST",5333,5450,5999,666
PSCO,"12/20/2022 11 a.m. MST",5185,5270,5865,680
PSCO,"12/20/2022 12 p.m. MST",5043,5111,5731,688
PSCO,"12/20/2022 1 p.m. MST",5002,5013,5578,576
PSCO,"12/20/2022 2 p.m. MST",5057,5013,5592,535
PSCO,"12/20/2022 3 p.m. MST",5149,5033,5671,522
PSCO,"12/20/2022 4 p.m. MST",5337,5213,5810,473
PSCO,"12/20/2022 5 p.m. MST",5638,5555,6235,597
PSCO,"12/20/2022 6 p.m. MST",5971,5940,6621,650
PSCO,"12/20/2022 7 p.m. MST",5911,5910,6431,520
PSCO,"12/20/2022 8 p.m. MST",5847,5816,6366,519
PSCO,"12/20/2022 9 p.m. MST",5785,5735,6199,414
PSCO,"12/20/2022 10 p.m. MST",5609,5478,6107,498
PSCO,"12/20/2022 11 p.m. MST",5254,5169,5909,655
PSCO,"12/21/2022 12 a.m. MST",5027,4945,5607,580
PSCO,"12/21/2022 1 a.m. MST",4845,4700,5344,499
PSCO,"12/21/2022 2 a.m. MST",4788,4605,5232,444
PSCO,"12/21/2022 3 a.m. MST",4742,4654,5335,593
PSCO,"12/21/2022 4 a.m. MST",4766,4639,5390,624
PSCO,"12/21/2022 5 a.m. MST",4876,4765,5309,433
PSCO,"12/21/2022 6 a.m. MST",5127,4981,5588,461
PSCO,"12/21/2022 7 a.m. MST",5475,5357,5906,431
PSCO,"12/21/2022 8 a.m. MST",5637,5597,6224,587
PSCO,"12/21/2022 9 a.m. MST",5505,5428,6086,581
PSCO,"12/21/2022 10 a.m. MST",5322,5360,5916,594
PSCO,"12/21/2022 11 a.m. MST",5152,5286,5875,723
PSCO,"12/21/2022 12 p.m. MST",5036,5100,5663,627
PSCO,"12/21/2022 1 p.m. MST",4940,4948,5609,669
PSCO,"12/21/2022 2 p.m. MST",5011,4929,5715,704
PSCO,"12/21/2022 3 p.m. MST",5139,5048,5854,715
PSCO,"12/21/2022 4 p.m. MST",5304,5351,5820,516
PSCO,"12/21/2022 5 p.m. MST",5720,5790,6152,432
PSCO,"12/21/2022 6 p.m. MST",6331,6005,6595,264
PSCO,"12/21/2022 7 p.m. MST",6441,6013,6788,347
PSCO,"12/21/2022 8 p.m. MST",6442,5975,6810,368
PSCO,"12/21/2022 9 p.m. MST",6357,5931,6670,313
PSCO,"12/21/2022 10 p.m. MST",6181,5802,6538,357
PSCO,"12/21/2022 11 p.m. MST",5862,5547,6372,510
PSCO,"12/22/2022 12 a.m. MST",5658,5449,6363,705
PSCO,"12/22/2022 1 a.m. MST",5489,5288,5742,253
PSCO,"12/22/2022 2 a.m. MST",5428,5305,5619,191
PSCO,"12/22/2022 3 a.m. MST",5406,5220,5649,243
PSCO,"12/22/2022 4 a.m. MST",5449,5271,5771,322
PSCO,"12/22/2022 5 a.m. MST",5529,5310,5850,321
PSCO,"12/22/2022 6 a.m. MST",5699,5386,6006,307
PSCO,"12/22/2022 7 a.m. MST",6029,5742,6114,85
PSCO,"12/22/2022 8 a.m. MST",6254,6012,6286,32
PSCO,"12/22/2022 9 a.m. MST",6333,6252,6528,195
PSCO,"12/22/2022 10 a.m. MST",6435,6318,6805,370
PSCO,"12/22/2022 11 a.m. MST",6512,6277,6698,186
PSCO,"12/22/2022 12 p.m. MST",6458,6211,6652,194
PSCO,"12/22/2022 1 p.m. MST",6467,6151,6725,258
PSCO,"12/22/2022 2 p.m. MST",6371,5915,6721,350
PSCO,"12/22/2022 3 p.m. MST",6319,5958,6671,352
PSCO,"12/22/2022 4 p.m. MST",6373,5945,6660,287
PSCO,"12/22/2022 5 p.m. MST",6625,6377,6837,212
PSCO,"12/22/2022 6 p.m. MST",6964,6816,7284,320
PSCO,"12/22/2022 7 p.m. MST",6882,6774,7242,360
PSCO,"12/22/2022 8 p.m. MST",6766,6740,7061,295
PSCO,"12/22/2022 9 p.m. MST",6630,6490,6862,232
PSCO,"12/22/2022 10 p.m. MST",6395,6420,6679,284
PSCO,"12/22/2022 11 p.m. MST",6111,6001,6318,207
PSCO,"12/23/2022 12 a.m. MST",5810,5741,6033,223
PSCO,"12/23/2022 1 a.m. MST",5637,5638,5726,89
PSCO,"12/23/2022 2 a.m. MST",5514,5468,5602,88
PSCO,"12/23/2022 3 a.m. MST",5484,5531,5361,-123
PSCO,"12/23/2022 4 a.m. MST",5510,5542,5349,-161
PSCO,"12/23/2022 5 a.m. MST",5530,5561,5309,-221
PSCO,"12/23/2022 6 a.m. MST",5715,5660,5376,-339
PSCO,"12/23/2022 7 a.m. MST",5969,5860,5722,-247
PSCO,"12/23/2022 8 a.m. MST",6157,6131,5960,-197
PSCO,"12/23/2022 9 a.m. MST",6266,6121,6067,-199
PSCO,"12/23/2022 10 a.m. MST",6267,6031,6163,-104
PSCO,"12/23/2022 11 a.m. MST",6213,5801,6227,14
PSCO,"12/23/2022 12 p.m. MST",6147,5663,6284,137
PSCO,"12/23/2022 1 p.m. MST",6029,5596,6149,120
PSCO,"12/23/2022 2 p.m. MST",5932,5457,6097,165
PSCO,"12/23/2022 3 p.m. MST",5909,5476,6189,280
PSCO,"12/23/2022 4 p.m. MST",5987,5597,6047,60
PSCO,"12/23/2022 5 p.m. MST",6291,5986,6482,191
PSCO,"12/23/2022 6 p.m. MST",6616,6364,6689,73
PSCO,"12/23/2022 7 p.m. MST",6565,6354,6605,40
PSCO,"12/23/2022 8 p.m. MST",6479,6209,6478,-1
PSCO,"12/23/2022 9 p.m. MST",6383,6142,6218,-165
PSCO,"12/23/2022 10 p.m. MST",6147,6016,6089,-58
PSCO,"12/23/2022 11 p.m. MST",5835,5804,5952,117
PSCO,"12/24/2022 12 a.m. MST",5499,5448,5765,266
PSCO,"12/24/2022 1 a.m. MST",5252,5051,5489,237
PSCO,"12/24/2022 2 a.m. MST",5138,5040,5621,483
PSCO,"12/24/2022 3 a.m. MST",5018,4975,5300,282
PSCO,"12/24/2022 4 a.m. MST",5022,4918,5231,209
PSCO,"12/24/2022 5 a.m. MST",5040,4882,5246,206
PSCO,"12/24/2022 6 a.m. MST",5108,4881,5258,150
PSCO,"12/24/2022 7 a.m. MST",5260,5055,5489,229
PSCO,"12/24/2022 8 a.m. MST",5381,5248,5686,305
PSCO,"12/24/2022 9 a.m. MST",5417,5269,5638,221
PSCO,"12/24/2022 10 a.m. MST",5395,5142,5651,256
PSCO,"12/24/2022 11 a.m. MST",5361,4873,5443,82
PSCO,"12/24/2022 12 p.m. MST",5216,4797,5295,79
PSCO,"12/24/2022 1 p.m. MST",5092,4641,5222,130
PSCO,"12/24/2022 2 p.m. MST",5139,4511,5248,109
PSCO,"12/24/2022 3 p.m. MST",5034,4637,5057,23
PSCO,"12/24/2022 4 p.m. MST",5073,4984,5151,78
PSCO,"12/24/2022 5 p.m. MST",5321,5331,5446,125
PSCO,"12/24/2022 6 p.m. MST",5585,5543,5855,270
PSCO,"12/24/2022 7 p.m. MST",5501,5536,5822,321
PSCO,"12/24/2022 8 p.m. MST",5392,5520,5889,497
PSCO,"12/24/2022 9 p.m. MST",5300,5460,5886,586
PSCO,"12/24/2022 10 p.m. MST",5189,5274,5746,557
PSCO,"12/24/2022 11 p.m. MST",5024,5079,5606,582
PSCO,"12/25/2022 12 a.m. MST",4827,4931,5458,631
PSCO,"12/25/2022 1 a.m. MST",4694,4758,5406,712
PSCO,"12/25/2022 2 a.m. MST",4601,4709,5171,570
PSCO,"12/25/2022 3 a.m. MST",4520,4668,5100,580
PSCO,"12/25/2022 4 a.m. MST",4505,4574,5007,502
PSCO,"12/25/2022 5 a.m. MST",4508,4661,5085,577
PSCO,"12/25/2022 6 a.m. MST",4588,4736,5159,571
PSCO,"12/25/2022 7 a.m. MST",4700,4890,5225,525
PSCO,"12/25/2022 8 a.m. MST",4895,4957,5296,401
PSCO,"12/25/2022 9 a.m. MST",4935,4805,5321,386
PSCO,"12/25/2022 10 a.m. MST",4854,4574,5123,269
PSCO,"12/25/2022 11 a.m. MST",4771,4526,4996,225
PSCO,"12/25/2022 12 p.m. MST",4807,4425,4924,117
PSCO,"12/25/2022 1 p.m. MST",4802,4387,4828,26
PSCO,"12/25/2022 2 p.m. MST",4739,4335,4773,34
PSCO,"12/25/2022 3 p.m. MST",4716,4407,4894,178
PSCO,"12/25/2022 4 p.m. MST",4768,4471,4932,164
PSCO,"12/25/2022 5 p.m. MST",5026,4864,5209,183
PSCO,"12/25/2022 6 p.m. MST",5274,5026,5551,277
PSCO,"12/25/2022 7 p.m. MST",5180,5177,5567,387
PSCO,"12/25/2022 8 p.m. MST",5121,5061,5603,482
PSCO,"12/25/2022 9 p.m. MST",5069,5184,5559,490
PSCO,"12/25/2022 10 p.m. MST",4932,5013,5437,505
PSCO,"12/25/2022 11 p.m. MST",4734,4751,5346,612
PSCO,"12/26/2022 12 a.m. MST",4513,4561,5112,599
PSCO,"12/26/2022 1 a.m. MST",4360,4490,5053,693
PSCO,"12/26/2022 2 a.m. MST",4274,4460,4945,671
PSCO,"12/26/2022 3 a.m. MST",4250,4430,4982,732
PSCO,"12/26/2022 4 a.m. MST",4271,4418,4757,486
PSCO,"12/26/2022 5 a.m. MST",4363,4509,4905,542
PSCO,"12/26/2022 6 a.m. MST",4541,4549,5083,542
PSCO,"12/26/2022 7 a.m. MST",4780,4740,5352,572
PSCO,"12/26/2022 8 a.m. MST",4877,4775,5321,444
PSCO,"12/26/2022 9 a.m. MST",4860,4606,5395,535
PSCO,"12/26/2022 10 a.m. MST",4755,4656,5150,395
PSCO,"12/26/2022 11 a.m. MST",4625,4670,4915,290
PSCO,"12/26/2022 12 p.m. MST",4534,4704,4847,313
PSCO,"12/26/2022 1 p.m. MST",4546,4668,4804,258
PSCO,"12/26/2022 2 p.m. MST",4614,4714,4883,269
PSCO,"12/26/2022 3 p.m. MST",4800,4813,5118,318
PSCO,"12/26/2022 4 p.m. MST",4983,4961,5332,349
PSCO,"12/26/2022 5 p.m. MST",5347,5367,5743,396
PSCO,"12/26/2022 6 p.m. MST",5678,5611,6188,510
PSCO,"12/26/2022 7 p.m. MST",5628,5833,6211,583
PSCO,"12/26/2022 8 p.m. MST",5529,5581,6119,590
PSCO,"12/26/2022 9 p.m. MST",5375,5523,6006,631
PSCO,"12/26/2022 10 p.m. MST",5134,5125,5793,659
PSCO,"12/26/2022 11 p.m. MST",4825,4769,5411,586
PSCO,"12/27/2022 12 a.m. MST",4522,4705,5064,542
PSCO,"12/27/2022 1 a.m. MST",4392,4460,4918,526
PSCO,"12/27/2022 2 a.m. MST",4271,4359,4732,461
PSCO,"12/27/2022 3 a.m. MST",4204,4382,4635,431
PSCO,"12/27/2022 4 a.m. MST",4258,4416,4682,424
PSCO,"12/27/2022 5 a.m. MST",4380,4538,4913,533
PSCO,"12/27/2022 6 a.m. MST",4645,4741,5236,591
PSCO,"12/27/2022 7 a.m. MST",4931,4975,5357,426
PSCO,"12/27/2022 8 a.m. MST",5100,5119,5768,668
PSCO,"12/27/2022 9 a.m. MST",4972,5081,5651,679
PSCO,"12/27/2022 10 a.m. MST",4898,4988,5422,524
PSCO,"12/27/2022 11 a.m. MST",4899,4881,5295,396
PSCO,"12/27/2022 12 p.m. MST",4846,4766,5337,491
PSCO,"12/27/2022 1 p.m. MST",4950,4763,5546,596
PSCO,"12/27/2022 2 p.m. MST",5056,4635,5580,524
PSCO,"12/27/2022 3 p.m. MST",5047,4613,5506,459
PSCO,"12/27/2022 4 p.m. MST",5124,4868,5604,480
PSCO,"12/27/2022 5 p.m. MST",5354,5198,5940,586
PSCO,"12/27/2022 6 p.m. MST",5609,5495,6202,593
PSCO,"12/27/2022 7 p.m. MST",5482,5433,6137,655
PSCO,"12/27/2022 8 p.m. MST",5339,5336,6005,666
PSCO,"12/27/2022 9 p.m. MST",5212,5201,5829,617
PSCO,"12/27/2022 10 p.m. MST",4976,5029,5597,621
PSCO,"12/27/2022 11 p.m. MST",4690,4779,5265,575
PSCO,"12/28/2022 12 a.m. MST",4399,4519,4953,554
PSCO,"12/28/2022 1 a.m. MST",4252,4311,4658,406
PSCO,"12/28/2022 2 a.m. MST",4150,4161,4450,300
PSCO,"12/28/2022 3 a.m. MST",4130,4169,4420,290
PSCO,"12/28/2022 4 a.m. MST",4117,4205,4367,250
PSCO,"12/28/2022 5 a.m. MST",4164,4296,4407,243
PSCO,"12/28/2022 6 a.m. MST",4379,4541,4714,335
PSCO,"12/28/2022 7 a.m. MST",4676,4900,4945,269
PSCO,"12/28/2022 8 a.m. MST",4885,5091,5088,203
PSCO,"12/28/2022 9 a.m. MST",4935,5091,5246,311
PSCO,"12/28/2022 10 a.m. MST",4888,5174,5175,287
PSCO,"12/28/2022 11 a.m. MST",4936,5184,5119,183
PSCO,"12/28/2022 12 p.m. MST",4989,5201,5179,190
PSCO,"12/28/2022 1 p.m. MST",5086,5128,5343,257
PSCO,"12/28/2022 2 p.m. MST",5164,5093,5407,243
PSCO,"12/28/2022 3 p.m. MST",5261,5071,5630,369
PSCO,"12/28/2022 4 p.m. MST",5351,5180,5756,405
PSCO,"12/28/2022 5 p.m. MST",5585,5503,5916,331
PSCO,"12/28/2022 6 p.m. MST",5833,5801,6322,489
PSCO,"12/28/2022 7 p.m. MST",5782,5747,6308,526
PSCO,"12/28/2022 8 p.m. MST",5695,5598,6259,564
PSCO,"12/28/2022 9 p.m. MST",5533,5396,6088,555
PSCO,"12/28/2022 10 p.m. MST",5298,5234,5831,533
PSCO,"12/28/2022 11 p.m. MST",4967,4976,5494,527
PSCO,"12/29/2022 12 a.m. MST",4713,4792,5117,404
PSCO,"12/29/2022 1 a.m. MST",4551,4761,4936,385
PSCO,"12/29/2022 2 a.m. MST",4443,4664,4883,440
PSCO,"12/29/2022 3 a.m. MST",4450,4461,5006,556
PSCO,"12/29/2022 4 a.m. MST",4444,4481,4833,389
PSCO,"12/29/2022 5 a.m. MST",4521,4564,4718,197
PSCO,"12/29/2022 6 a.m. MST",4748,4730,4826,78
PSCO,"12/29/2022 7 a.m. MST",5066,4995,5076,10
PSCO,"12/29/2022 8 a.m. MST",5306,5194,5346,40
PSCO,"12/29/2022 9 a.m. MST",5407,5192,5502,95
PSCO,"12/29/2022 10 a.m. MST",5393,5223,5705,312
PSCO,"12/29/2022 11 a.m. MST",5390,5195,5733,343
PSCO,"12/29/2022 12 p.m. MST",5316,5201,5679,363
PSCO,"12/29/2022 1 p.m. MST",5292,5124,5372,80
PSCO,"12/29/2022 2 p.m. MST",5222,5060,5272,50
PSCO,"12/29/2022 3 p.m. MST",5192,4970,5143,-49
PSCO,"12/29/2022 4 p.m. MST",5290,5147,5224,-66
PSCO,"12/29/2022 5 p.m. MST",5577,5443,5596,19
PSCO,"12/29/2022 6 p.m. MST",5942,5767,6015,73
PSCO,"12/29/2022 7 p.m. MST",5880,5824,5897,17
PSCO,"12/29/2022 8 p.m. MST",5795,5756,5809,14
PSCO,"12/29/2022 9 p.m. MST",5688,5610,5696,8
PSCO,"12/29/2022 10 p.m. MST",5470,5485,5629,159
PSCO,"12/29/2022 11 p.m. MST",5228,5190,5399,171
PSCO,"12/30/2022 12 a.m. MST",4929,4976,5088,159
PSCO,"12/30/2022 1 a.m. MST",4776,4757,4957,181
PSCO,"12/30/2022 2 a.m. MST",4683,4659,4858,175
PSCO,"12/30/2022 3 a.m. MST",4655,4586,4959,304
PSCO,"12/30/2022 4 a.m. MST",4684,4637,5021,337
PSCO,"12/30/2022 5 a.m. MST",4784,4735,5024,240
PSCO,"12/30/2022 6 a.m. MST",4980,4862,5177,197
PSCO,"12/30/2022 7 a.m. MST",5224,5101,5439,215
PSCO,"12/30/2022 8 a.m. MST",5342,5313,5652,310
PSCO,"12/30/2022 9 a.m. MST",5363,5287,5721,358
PSCO,"12/30/2022 10 a.m. MST",5252,5172,5665,413
PSCO,"12/30/2022 11 a.m. MST",5187,4967,5594,407
PSCO,"12/30/2022 12 p.m. MST",5087,4863,5587,500
PSCO,"12/30/2022 1 p.m. MST",5041,4771,5499,458
PSCO,"12/30/2022 2 p.m. MST",4987,4759,5409,422
PSCO,"12/30/2022 3 p.m. MST",5056,4788,5380,324
PSCO,"12/30/2022 4 p.m. MST",5073,5029,5299,226
PSCO,"12/30/2022 5 p.m. MST",5317,5247,5533,216
PSCO,"12/30/2022 6 p.m. MST",5685,5666,6017,332
PSCO,"12/30/2022 7 p.m. MST",5604,5562,5952,348
PSCO,"12/30/2022 8 p.m. MST",5481,5509,5811,330
PSCO,"12/30/2022 9 p.m. MST",5384,5332,5593,209
PSCO,"12/30/2022 10 p.m. MST",5185,5180,5426,241
PSCO,"12/30/2022 11 p.m. MST",4964,4923,5240,276
PSCO,"12/31/2022 12 a.m. MST",4777,4628,4980,203
PSCO,"12/31/2022 1 a.m. MST",4597,4496,4704,107
PSCO,"12/31/2022 2 a.m. MST",4441,4447,4566,125
PSCO,"12/31/2022 3 a.m. MST",4390,4450,4550,160
PSCO,"12/31/2022 4 a.m. MST",4373,4462,4503,130
PSCO,"12/31/2022 5 a.m. MST",4377,4486,4465,88
PSCO,"12/31/2022 6 a.m. MST",4469,4568,4703,234
PSCO,"12/31/2022 7 a.m. MST",4657,4743,4854,197
PSCO,"12/31/2022 8 a.m. MST",4718,4901,5077,359
PSCO,"12/31/2022 9 a.m. MST",4762,4934,5062,300
PSCO,"12/31/2022 10 a.m. MST",4759,4749,5174,415
PSCO,"12/31/2022 11 a.m. MST",4672,4533,5262,590
PSCO,"12/31/2022 12 p.m. MST",4596,4590,5349,753
PSCO,"12/31/2022 1 p.m. MST",4563,4479,5568,1005
PSCO,"12/31/2022 2 p.m. MST",4557,4306,5507,950
PSCO,"12/31/2022 3 p.m. MST",4557,4632,5073,516
PSCO,"12/31/2022 4 p.m. MST",4667,4678,5014,347
PSCO,"12/31/2022 5 p.m. MST",4985,5055,5059,74
PSCO,"12/31/2022 6 p.m. MST",5357,5335,5686,329
PSCO,"12/31/2022 7 p.m. MST",5318,5160,5679,361
PSCO,"12/31/2022 8 p.m. MST",5171,5113,5541,370
PSCO,"12/31/2022 9 p.m. MST",5005,5102,5453,448
PSCO,"12/31/2022 10 p.m. MST",4850,4951,5049,199
PSCO,"12/31/2022 11 p.m. MST",4673,4813,4837,164
PSCO,"1/1/2023 12 a.m. MST",4564,4532,4779,215
