"BA Code","Timestamp (Hour Ending)","Demand (MWh)","Demand Forecast (MWh)","Net Generation (MWh)","Total Interchange (MWh)"
PSCO,"2/1/2023 12 a.m. MST",5253,5055,5797,544
PSCO,"2/1/2023 1 a.m. MST",5112,4918,5552,440
PSCO,"2/1/2023 2 a.m. MST",5058,4853,5455,397
PSCO,"2/1/2023 3 a.m. MST",5024,4838,5421,397
PSCO,"2/1/2023 4 a.m. MST",5051,4925,5488,437
PSCO,"2/1/2023 5 a.m. MST",5151,5049,5562,411
PSCO,"2/1/2023 6 a.m. MST",5352,5269,5744,392
PSCO,"2/1/2023 7 a.m. MST",5768,5706,6032,264
PSCO,"2/1/2023 8 a.m. MST",5947,5811,6325,378
PSCO,"2/1/2023 9 a.m. MST",5764,5662,6243,479
PSCO,"2/1/2023 10 a.m. MST",5532,5517,6237,705
PSCO,"2/1/2023 11 a.m. MST",5312,5338,5883,571
PSCO,"2/1/2023 12 p.m. MST",5119,5141,5571,452
PSCO,"2/1/2023 1 p.m. MST",5033,5035,5406,373
PSCO,"2/1/2023 2 p.m. MST",4895,4988,5384,489
PSCO,"2/1/2023 3 p.m. MST",4871,4919,5377,506
PSCO,"2/1/2023 4 p.m. MST",5018,5015,5235,217
PSCO,"2/1/2023 5 p.m. MST",5252,5246,5509,257
PSCO,"2/1/2023 6 p.m. MST",5657,5620,6060,403
PSCO,"2/1/2023 7 p.m. MST",5816,5786,6265,449
PSCO,"2/1/2023 8 p.m. MST",5763,5719,6284,521
PSCO,"2/1/2023 9 p.m. MST",5664,5579,6140,476
PSCO,"2/1/2023 10 p.m. MST",5428,5385,6048,620
PSCO,"2/1/2023 11 p.m. MST",5133,5087,5807,674
PSCO,"2/2/2023 12 a.m. MST",4879,4865,5556,677
PSCO,"2/2/2023 1 a.m. MST",4686,4761,5527,841
PSCO,"2/2/2023 2 a.m. MST",4633,4658,5573,940
PSCO,"2/2/2023 3 a.m. MST",4597,4659,5393,796
PSCO,"2/2/2023 4 a.m. MST",4684,4692,5448,764
PSCO,"2/2/2023 5 a.m. MST",4791,4803,5575,784
PSCO,"2/2/2023 6 a.m. MST",5123,5098,5887,764
PSCO,"2/2/2023 7 a.m. MST",5480,5517,6094,614
PSCO,"2/2/2023 8 a.m. MST",5663,5643,6374,711
PSCO,"2/2/2023 9 a.m. MST",5454,5491,5877,423
PSCO,"2/2/2023 10 a.m. MST",5172,5324,5527,355
PSCO,"2/2/2023 11 a.m. MST",5025,5122,5280,255
PSCO,"2/2/2023 12 p.m. MST",4914,4983,5171,257
PSCO,"2/2/2023 1 p.m. MST",4782,4851,4984,202
PSCO,"2/2/2023 2 p.m. MST",4788,4776,4973,185
PSCO,"2/2/2023 3 p.m. MST",4740,4786,4969,229
PSCO,"2/2/2023 4 p.m. MST",4806,4910,5041,235
PSCO,"2/2/2023 5 p.m. MST",5118,5167,5408,290
PSCO,"2/2/2023 6 p.m. MST",5503,5456,5788,285
PSCO,"2/2/2023 7 p.m. MST",5656,5607,5999,343
PSCO,"2/2/2023 8 p.m. MST",5601,5550,6044,443
PSCO,"2/2/2023 9 p.m. MST",5486,5452,5896,410
PSCO,"2/2/2023 10 p.m. MST",5256,5269,5794,538
PSCO,"2/2/2023 11 p.m. MST",5025,5002,5552,527
PSCO,"2/3/2023 12 a.m. MST",4769,4736,5438,669
PSCO,"2/3/2023 1 a.m. MST",4705,4609,5472,767
PSCO,"2/3/2023 2 a.m. MST",4648,4495,5470,822
PSCO,"2/3/2023 3 a.m. MST",4566,4492,5384,818
PSCO,"2/3/2023 4 a.m. MST",4639,4532,5462,823
PSCO,"2/3/2023 5 a.m. MST",4803,4674,5370,567
PSCO,"2/3/2023 6 a.m. MST",5021,4915,5574,553
PSCO,"2/3/2023 7 a.m. MST",5408,5327,5928,520
PSCO,"2/3/2023 8 a.m. MST",5600,5456,6110,510
PSCO,"2/3/2023 9 a.m. MST",5382,5290,5874,492
PSCO,"2/3/2023 10 a.m. MST",5161,5080,5475,314
PSCO,"2/3/2023 11 a.m. MST",4950,4908,5168,218
PSCO,"2/3/2023 12 p.m. MST",4789,4729,5061,272
PSCO,"2/3/2023 1 p.m. MST",4709,4612,5009,300
PSCO,"2/3/2023 2 p.m. MST",4684,4567,4932,248
PSCO,"2/3/2023 3 p.m. MST",4730,4504,4897,167
PSCO,"2/3/2023 4 p.m. MST",4798,4614,4943,145
PSCO,"2/3/2023 5 p.m. MST",4981,4872,5118,137
PSCO,"2/3/2023 6 p.m. MST",5345,5170,5513,168
PSCO,"2/3/2023 7 p.m. MST",5434,5287,5663,229
PSCO,"2/3/2023 8 p.m. MST",5341,5227,5494,153
PSCO,"2/3/2023 9 p.m. MST",5251,5097,5463,212
PSCO,"2/3/2023 10 p.m. MST",5075,4967,5159,84
PSCO,"2/3/2023 11 p.m. MST",4838,4786,4989,151
PSCO,"2/4/2023 12 a.m. MST",4570,4517,4875,305
PSCO,"2/4/2023 1 a.m. MST",,4314,,
PSCO,"2/4/2023 2 a.m. MST",,4267,,
PSCO,"2/4/2023 3 a.m. MST",,4211,,
PSCO,"2/4/2023 4 a.m. MST",,4297,,
PSCO,"2/4/2023 5 a.m. MST",,4379,,
PSCO,"2/4/2023 6 a.m. MST",,4537,,
PSCO,"2/4/2023 7 a.m. MST",,4779,,
PSCO,"2/4/2023 8 a.m. MST",,4891,,
PSCO,"2/4/2023 9 a.m. MST",,4845,,
PSCO,"2/4/2023 10 a.m. MST",,4761,,
PSCO,"2/4/2023 11 a.m. MST",,4585,,
PSCO,"2/4/2023 12 p.m. MST",,4442,,
PSCO,"2/4/2023 1 p.m. MST",,4275,,
PSCO,"2/4/2023 2 p.m. MST",,4205,,
PSCO,"2/4/2023 3 p.m. MST",,4316,,
PSCO,"2/4/2023 4 p.m. MST",,4409,,
PSCO,"2/4/2023 5 p.m. MST",,4677,,
PSCO,"2/4/2023 6 p.m. MST",,5046,,
PSCO,"2/4/2023 7 p.m. MST",,5132,,
PSCO,"2/4/2023 8 p.m. MST",,5036,,
PSCO,"2/4/2023 9 p.m. MST",,5010,,
PSCO,"2/4/2023 10 p.m. MST",,4849,,
PSCO,"2/4/2023 11 p.m. MST",,4694,,
PSCO,"2/5/2023 12 a.m. MST",,4475,,
PSCO,"2/5/2023 1 a.m. MST",4323,4356,4644,321
PSCO,"2/5/2023 2 a.m. MST",4239,4287,4508,269
PSCO,"2/5/2023 3 a.m. MST",4207,4302,4463,256
PSCO,"2/5/2023 4 a.m. MST",4210,4286,4517,307
PSCO,"2/5/2023 5 a.m. MST",4266,4291,4598,332
PSCO,"2/5/2023 6 a.m. MST",4381,4385,4682,301
PSCO,"2/5/2023 7 a.m. MST",4563,4554,4772,209
PSCO,"2/5/2023 8 a.m. MST",4667,4632,4902,235
PSCO,"2/5/2023 9 a.m. MST",4634,4482,4991,357
PSCO,"2/5/2023 10 a.m. MST",4427,4415,4622,195
PSCO,"2/5/2023 11 a.m. MST",4331,4324,4594,263
PSCO,"2/5/2023 12 p.m. MST",4212,4191,4427,215
PSCO,"2/5/2023 1 p.m. MST",4153,4080,4396,243
PSCO,"2/5/2023 2 p.m. MST",4132,4211,4414,282
PSCO,"2/5/2023 3 p.m. MST",4175,4370,4457,282
PSCO,"2/5/2023 4 p.m. MST",4327,4497,4610,283
PSCO,"2/5/2023 5 p.m. MST",4686,4834,4914,228
PSCO,"2/5/2023 6 p.m. MST",5183,5136,5453,270
PSCO,"2/5/2023 7 p.m. MST",5403,5275,5626,223
PSCO,"2/5/2023 8 p.m. MST",5266,5112,5293,27
PSCO,"2/5/2023 9 p.m. MST",5204,5058,5214,10
PSCO,"2/5/2023 10 p.m. MST",5002,4861,5169,167
PSCO,"2/5/2023 11 p.m. MST",4718,4602,4951,233
PSCO,"2/6/2023 12 a.m. MST",4460,4430,4595,135
PSCO,"2/6/2023 1 a.m. MST",4331,4313,4413,82
PSCO,"2/6/2023 2 a.m. MST",4254,4234,4365,111
PSCO,"2/6/2023 3 a.m. MST",4249,4221,4355,106
PSCO,"2/6/2023 4 a.m. MST",4276,4274,4472,196
PSCO,"2/6/2023 5 a.m. MST",4423,4432,4634,211
PSCO,"2/6/2023 6 a.m. MST",4669,4692,4859,190
PSCO,"2/6/2023 7 a.m. MST",5113,5125,5269,156
PSCO,"2/6/2023 8 a.m. MST",5331,5325,5444,113
PSCO,"2/6/2023 9 a.m. MST",5247,5146,5360,113
PSCO,"2/6/2023 10 a.m. MST",5057,5092,5110,53
PSCO,"2/6/2023 11 a.m. MST",4911,5000,4918,7
PSCO,"2/6/2023 12 p.m. MST",4804,4901,4848,44
PSCO,"2/6/2023 1 p.m. MST",4763,4878,4714,-49
PSCO,"2/6/2023 2 p.m. MST",5015,4882,4837,-178
PSCO,"2/6/2023 3 p.m. MST",4931,4844,4885,-46
PSCO,"2/6/2023 4 p.m. MST",5022,4942,5038,16
PSCO,"2/6/2023 5 p.m. MST",5246,5198,5145,-101
PSCO,"2/6/2023 6 p.m. MST",5609,5480,5592,-17
PSCO,"2/6/2023 7 p.m. MST",5738,5585,5797,59
PSCO,"2/6/2023 8 p.m. MST",5606,5501,5676,70
PSCO,"2/6/2023 9 p.m. MST",5402,5366,5505,103
PSCO,"2/6/2023 10 p.m. MST",5222,5141,5445,223
PSCO,"2/6/2023 11 p.m. MST",4925,4874,5141,216
PSCO,"2/7/2023 12 a.m. MST",4685,4634,4955,270
PSCO,"2/7/2023 1 a.m. MST",4567,4485,4805,238
PSCO,"2/7/2023 2 a.m. MST",4507,4391,4659,152
PSCO,"2/7/2023 3 a.m. MST",4508,4358,4764,256
PSCO,"2/7/2023 4 a.m. MST",4534,4394,4798,264
PSCO,"2/7/2023 5 a.m. MST",4697,4527,4873,176
PSCO,"2/7/2023 6 a.m. MST",4989,4806,5279,290
PSCO,"2/7/2023 7 a.m. MST",5419,5251,5697,278
PSCO,"2/7/2023 8 a.m. MST",5542,5385,5820,278
PSCO,"2/7/2023 9 a.m. MST",5308,5231,5539,231
PSCO,"2/7/2023 10 a.m. MST",4982,5055,5228,246
PSCO,"2/7/2023 11 a.m. MST",4941,4874,5225,284
PSCO,"2/7/2023 12 p.m. MST",4777,4706,5159,382
PSCO,"2/7/2023 1 p.m. MST",4663,4599,5041,378
PSCO,"2/7/2023 2 p.m. MST",4574,4509,4936,362
PSCO,"2/7/2023 3 p.m. MST",4593,4520,4737,144
PSCO,"2/7/2023 4 p.m. MST",4716,4642,4839,123
PSCO,"2/7/2023 5 p.m. MST",4939,4873,5034,95
PSCO,"2/7/2023 6 p.m. MST",5326,5198,5394,68
PSCO,"2/7/2023 7 p.m. MST",5504,5422,5701,197
PSCO,"2/7/2023 8 p.m. MST",5441,5367,5674,233
PSCO,"2/7/2023 9 p.m. MST",5409,5286,5791,382
PSCO,"2/7/2023 10 p.m. MST",5248,5059,5486,238
PSCO,"2/7/2023 11 p.m. MST",4960,4794,5256,296
PSCO,"2/8/2023 12 a.m. MST",4781,4568,5044,263
PSCO,"2/8/2023 1 a.m. MST",4592,4426,5023,431
PSCO,"2/8/2023 2 a.m. MST",4517,4340,4821,304
PSCO,"2/8/2023 3 a.m. MST",4560,4330,4792,232
PSCO,"2/8/2023 4 a.m. MST",4582,4379,4824,242
PSCO,"2/8/2023 5 a.m. MST",4704,4521,4926,222
PSCO,"2/8/2023 6 a.m. MST",4993,4805,5001,8
PSCO,"2/8/2023 7 a.m. MST",5334,5257,5328,-6
PSCO,"2/8/2023 8 a.m. MST",5503,5371,5567,64
PSCO,"2/8/2023 9 a.m. MST",5266,5194,5299,33
PSCO,"2/8/2023 10 a.m. MST",4998,4971,5225,227
PSCO,"2/8/2023 11 a.m. MST",4822,4803,5086,264
PSCO,"2/8/2023 12 p.m. MST",4690,4637,4973,283
PSCO,"2/8/2023 1 p.m. MST",4669,4573,4883,214
PSCO,"2/8/2023 2 p.m. MST",4808,4554,4968,160
PSCO,"2/8/2023 3 p.m. MST",4727,4548,4983,256
PSCO,"2/8/2023 4 p.m. MST",4666,4666,4977,311
PSCO,"2/8/2023 5 p.m. MST",4844,4879,4915,71
PSCO,"2/8/2023 6 p.m. MST",5357,5194,5400,43
PSCO,"2/8/2023 7 p.m. MST",5667,5358,5823,156
PSCO,"2/8/2023 8 p.m. MST",5599,5325,5757,158
PSCO,"2/8/2023 9 p.m. MST",5503,5215,5751,248
PSCO,"2/8/2023 10 p.m. MST",5276,4997,5602,326
PSCO,"2/8/2023 11 p.m. MST",4970,4744,5266,296
PSCO,"2/9/2023 12 a.m. MST",4761,4580,5039,278
PSCO,"2/9/2023 1 a.m. MST",4596,4429,4891,295
PSCO,"2/9/2023 2 a.m. MST",4559,4344,4914,355
PSCO,"2/9/2023 3 a.m. MST",4529,4372,4832,303
PSCO,"2/9/2023 4 a.m. MST",4558,4439,4901,343
PSCO,"2/9/2023 5 a.m. MST",4659,4598,5162,503
PSCO,"2/9/2023 6 a.m. MST",4956,4830,5404,448
PSCO,"2/9/2023 7 a.m. MST",5383,5273,5812,429
PSCO,"2/9/2023 8 a.m. MST",5553,5478,6053,500
PSCO,"2/9/2023 9 a.m. MST",5556,5444,6030,474
PSCO,"2/9/2023 10 a.m. MST",5449,5366,5702,253
PSCO,"2/9/2023 11 a.m. MST",5292,5258,5401,109
PSCO,"2/9/2023 12 p.m. MST",5215,5212,5207,-8
PSCO,"2/9/2023 1 p.m. MST",5197,5188,5356,159
PSCO,"2/9/2023 2 p.m. MST",5095,5206,5016,-79
PSCO,"2/9/2023 3 p.m. MST",5077,5220,4981,-96
PSCO,"2/9/2023 4 p.m. MST",5231,5267,5104,-127
PSCO,"2/9/2023 5 p.m. MST",5441,5380,5659,218
PSCO,"2/9/2023 6 p.m. MST",5850,5595,6085,235
PSCO,"2/9/2023 7 p.m. MST",5985,5749,6251,266
PSCO,"2/9/2023 8 p.m. MST",5882,5690,6147,265
PSCO,"2/9/2023 9 p.m. MST",5733,5555,6031,298
PSCO,"2/9/2023 10 p.m. MST",5484,5357,5787,303
PSCO,"2/9/2023 11 p.m. MST",5202,5077,5532,330
PSCO,"2/10/2023 12 a.m. MST",5012,4831,5281,269
PSCO,"2/10/2023 1 a.m. MST",4867,4708,5188,321
PSCO,"2/10/2023 2 a.m. MST",4814,4629,5179,365
PSCO,"2/10/2023 3 a.m. MST",4818,4613,5205,387
PSCO,"2/10/2023 4 a.m. MST",4847,4677,5171,324
PSCO,"2/10/2023 5 a.m. MST",4973,4792,5381,408
PSCO,"2/10/2023 6 a.m. MST",5235,5006,5530,295
PSCO,"2/10/2023 7 a.m. MST",5532,5375,5726,194
PSCO,"2/10/2023 8 a.m. MST",5659,5516,6034,375
PSCO,"2/10/2023 9 a.m. MST",5460,5408,5807,347
PSCO,"2/10/2023 10 a.m. MST",5195,5144,5504,309
PSCO,"2/10/2023 11 a.m. MST",4954,4960,5331,377
PSCO,"2/10/2023 12 p.m. MST",4775,4820,5048,273
PSCO,"2/10/2023 1 p.m. MST",4624,4671,4920,296
PSCO,"2/10/2023 2 p.m. MST",4536,4592,4751,215
PSCO,"2/10/2023 3 p.m. MST",4498,4575,4694,196
PSCO,"2/10/2023 4 p.m. MST",4618,4691,4804,186
PSCO,"2/10/2023 5 p.m. MST",4901,4880,5152,251
PSCO,"2/10/2023 6 p.m. MST",5312,5169,5757,445
PSCO,"2/10/2023 7 p.m. MST",5480,5318,5953,473
PSCO,"2/10/2023 8 p.m. MST",5429,5263,5909,480
PSCO,"2/10/2023 9 p.m. MST",5344,5185,5868,524
PSCO,"2/10/2023 10 p.m. MST",5160,5029,5700,540
PSCO,"2/10/2023 11 p.m. MST",4949,4820,5516,567
PSCO,"2/11/2023 12 a.m. MST",4737,4640,5248,511
PSCO,"2/11/2023 1 a.m. MST",4586,4505,4984,398
PSCO,"2/11/2023 2 a.m. MST",4523,4395,4911,388
PSCO,"2/11/2023 3 a.m. MST",4479,4405,4889,410
PSCO,"2/11/2023 4 a.m. MST",4482,4387,4868,386
PSCO,"2/11/2023 5 a.m. MST",4547,4441,5047,500
PSCO,"2/11/2023 6 a.m. MST",4660,4582,4992,332
PSCO,"2/11/2023 7 a.m. MST",4853,4830,5117,264
PSCO,"2/11/2023 8 a.m. MST",4866,4885,5306,440
PSCO,"2/11/2023 9 a.m. MST",4691,4714,5251,560
PSCO,"2/11/2023 10 a.m. MST",4547,4567,5178,631
PSCO,"2/11/2023 11 a.m. MST",4456,4402,4910,454
PSCO,"2/11/2023 12 p.m. MST",4302,4283,4773,471
PSCO,"2/11/2023 1 p.m. MST",4182,4184,4523,341
PSCO,"2/11/2023 2 p.m. MST",4199,4110,4546,347
PSCO,"2/11/2023 3 p.m. MST",4311,4214,4576,265
PSCO,"2/11/2023 4 p.m. MST",4429,4400,4725,296
PSCO,"2/11/2023 5 p.m. MST",4682,4674,5015,333
PSCO,"2/11/2023 6 p.m. MST",5011,4982,5177,166
PSCO,"2/11/2023 7 p.m. MST",5166,5144,5399,233
PSCO,"2/11/2023 8 p.m. MST",5094,5115,5332,238
PSCO,"2/11/2023 9 p.m. MST",5017,5026,5268,251
PSCO,"2/11/2023 10 p.m. MST",4876,4964,5242,366
PSCO,"2/11/2023 11 p.m. MST",4673,4732,5235,562
PSCO,"2/12/2023 12 a.m. MST",4455,4531,4931,476
PSCO,"2/12/2023 1 a.m. MST",4310,4303,4791,481
PSCO,"2/12/2023 2 a.m. MST",4238,4224,4691,453
PSCO,"2/12/2023 3 a.m. MST",4164,4244,4479,315
PSCO,"2/12/2023 4 a.m. MST",4206,4221,4485,279
PSCO,"2/12/2023 5 a.m. MST",4239,4237,4518,279
PSCO,"2/12/2023 6 a.m. MST",4357,4287,4606,249
PSCO,"2/12/2023 7 a.m. MST",4526,4433,4720,194
PSCO,"2/12/2023 8 a.m. MST",4572,4597,4940,368
PSCO,"2/12/2023 9 a.m. MST",4440,4662,4670,230
PSCO,"2/12/2023 10 a.m. MST",4382,4552,4507,125
PSCO,"2/12/2023 11 a.m. MST",4319,4479,4483,164
PSCO,"2/12/2023 12 p.m. MST",4245,4416,4524,279
PSCO,"2/12/2023 1 p.m. MST",4234,4041,4409,175
PSCO,"2/12/2023 2 p.m. MST",4241,4280,4319,78
PSCO,"2/12/2023 3 p.m. MST",4299,4333,4344,45
PSCO,"2/12/2023 4 p.m. MST",4465,4546,4635,170
PSCO,"2/12/2023 5 p.m. MST",4706,4674,4764,58
PSCO,"2/12/2023 6 p.m. MST",4952,4814,4920,-32
PSCO,"2/12/2023 7 p.m. MST",5049,5003,5023,-26
PSCO,"2/12/2023 8 p.m. MST",5017,4945,4981,-36
PSCO,"2/12/2023 9 p.m. MST",4971,4924,4982,11
PSCO,"2/12/2023 10 p.m. MST",4909,4807,5016,107
PSCO,"2/12/2023 11 p.m. MST",4654,4589,4791,137
PSCO,"2/13/2023 12 a.m. MST",4448,4329,4645,197
PSCO,"2/13/2023 1 a.m. MST",4277,4248,4520,243
PSCO,"2/13/2023 2 a.m. MST",4256,4168,4554,298
PSCO,"2/13/2023 3 a.m. MST",4260,4152,4618,358
PSCO,"2/13/2023 4 a.m. MST",4302,4222,4594,292
PSCO,"2/13/2023 5 a.m. MST",4475,4363,4742,267
PSCO,"2/13/2023 6 a.m. MST",4761,4635,4893,132
PSCO,"2/13/2023 7 a.m. MST",5163,5084,5266,103
PSCO,"2/13/2023 8 a.m. MST",5300,5233,5458,158
PSCO,"2/13/2023 9 a.m. MST",5019,5035,5084,65
PSCO,"2/13/2023 10 a.m. MST",4806,4858,5014,208
PSCO,"2/13/2023 11 a.m. MST",4696,4734,4871,175
PSCO,"2/13/2023 12 p.m. MST",4625,4598,4790,165
PSCO,"2/13/2023 1 p.m. MST",4623,4514,4756,133
PSCO,"2/13/2023 2 p.m. MST",4703,4458,4659,-44
PSCO,"2/13/2023 3 p.m. MST",4883,4484,4856,-27
PSCO,"2/13/2023 4 p.m. MST",4905,4613,4911,6
PSCO,"2/13/2023 5 p.m. MST",5068,4919,4997,-71
PSCO,"2/13/2023 6 p.m. MST",5333,5154,5333,0
PSCO,"2/13/2023 7 p.m. MST",5439,5281,5610,171
PSCO,"2/13/2023 8 p.m. MST",5351,5221,5505,154
PSCO,"2/13/2023 9 p.m. MST",5259,5080,5315,56
PSCO,"2/13/2023 10 p.m. MST",5005,4845,5059,54
PSCO,"2/13/2023 11 p.m. MST",4684,4566,4816,132
PSCO,"2/14/2023 12 a.m. MST",4444,4359,4667,223
PSCO,"2/14/2023 1 a.m. MST",4294,4165,4568,274
PSCO,"2/14/2023 2 a.m. MST",4221,4097,4535,314
PSCO,"2/14/2023 3 a.m. MST",4206,4122,4406,200
PSCO,"2/14/2023 4 a.m. MST",4205,4179,4568,363
PSCO,"2/14/2023 5 a.m. MST",4330,4311,4597,267
PSCO,"2/14/2023 6 a.m. MST",4582,4573,4770,188
PSCO,"2/14/2023 7 a.m. MST",5058,5022,5264,206
PSCO,"2/14/2023 8 a.m. MST",5183,5206,5401,218
PSCO,"2/14/2023 9 a.m. MST",5018,5230,5164,146
PSCO,"2/14/2023 10 a.m. MST",4829,5092,4859,30
PSCO,"2/14/2023 11 a.m. MST",4794,5042,4810,16
PSCO,"2/14/2023 12 p.m. MST",4709,4928,4731,22
PSCO,"2/14/2023 1 p.m. MST",4689,4886,4791,102
PSCO,"2/14/2023 2 p.m. MST",4735,4919,4780,45
PSCO,"2/14/2023 3 p.m. MST",4737,4984,4707,-30
PSCO,"2/14/2023 4 p.m. MST",4856,5103,4839,-17
PSCO,"2/14/2023 5 p.m. MST",5142,5307,5150,8
PSCO,"2/14/2023 6 p.m. MST",5591,5450,5752,161
PSCO,"2/14/2023 7 p.m. MST",5721,5496,5923,202
PSCO,"2/14/2023 8 p.m. MST",5604,5443,5828,224
PSCO,"2/14/2023 9 p.m. MST",5487,5326,5811,324
PSCO,"2/14/2023 10 p.m. MST",5292,5128,5628,336
PSCO,"2/14/2023 11 p.m. MST",5024,4834,5398,374
PSCO,"2/15/2023 12 a.m. MST",4811,4764,5192,381
PSCO,"2/15/2023 1 a.m. MST",4658,4643,4932,274
PSCO,"2/15/2023 2 a.m. MST",4625,4534,4987,362
PSCO,"2/15/2023 3 a.m. MST",4610,4556,5081,471
PSCO,"2/15/2023 4 a.m. MST",4657,4616,5159,502
PSCO,"2/15/2023 5 a.m. MST",4828,4729,5387,559
PSCO,"2/15/2023 6 a.m. MST",5003,4964,5587,584
PSCO,"2/15/2023 7 a.m. MST",5415,5355,5891,476
PSCO,"2/15/2023 8 a.m. MST",5701,5555,5951,250
PSCO,"2/15/2023 9 a.m. MST",5900,5620,6078,178
PSCO,"2/15/2023 10 a.m. MST",6025,5651,6247,222
PSCO,"2/15/2023 11 a.m. MST",6090,5657,6319,229
PSCO,"2/15/2023 12 p.m. MST",6090,5643,6429,339
PSCO,"2/15/2023 1 p.m. MST",6053,5619,6391,338
PSCO,"2/15/2023 2 p.m. MST",6020,5612,6288,268
PSCO,"2/15/2023 3 p.m. MST",5944,5594,6083,139
PSCO,"2/15/2023 4 p.m. MST",6047,5631,6170,123
PSCO,"2/15/2023 5 p.m. MST",6153,5759,6307,154
PSCO,"2/15/2023 6 p.m. MST",6339,6040,6676,337
PSCO,"2/15/2023 7 p.m. MST",6452,6079,6843,391
PSCO,"2/15/2023 8 p.m. MST",6299,5945,6758,459
PSCO,"2/15/2023 9 p.m. MST",6130,5750,6577,447
PSCO,"2/15/2023 10 p.m. MST",5817,5482,6437,620
PSCO,"2/15/2023 11 p.m. MST",5522,5236,6145,623
PSCO,"2/16/2023 12 a.m. MST",5124,4979,5836,712
PSCO,"2/16/2023 1 a.m. MST",4944,4925,5693,749
PSCO,"2/16/2023 2 a.m. MST",4885,4851,5612,727
PSCO,"2/16/2023 3 a.m. MST",4891,4849,5621,730
PSCO,"2/16/2023 4 a.m. MST",4952,4914,5660,708
PSCO,"2/16/2023 5 a.m. MST",5188,4981,5780,592
PSCO,"2/16/2023 6 a.m. MST",5431,5236,6050,619
PSCO,"2/16/2023 7 a.m. MST",5817,5604,6404,587
PSCO,"2/16/2023 8 a.m. MST",6051,5735,6565,514
PSCO,"2/16/2023 9 a.m. MST",6070,5592,6577,507
PSCO,"2/16/2023 10 a.m. MST",5984,5264,6598,614
PSCO,"2/16/2023 11 a.m. MST",5867,5092,6366,499
PSCO,"2/16/2023 12 p.m. MST",5715,4960,6204,489
PSCO,"2/16/2023 1 p.m. MST",5510,4830,5891,381
PSCO,"2/16/2023 2 p.m. MST",5400,4764,5732,332
PSCO,"2/16/2023 3 p.m. MST",5289,4749,5600,311
PSCO,"2/16/2023 4 p.m. MST",5272,4821,5591,319
PSCO,"2/16/2023 5 p.m. MST",5500,5090,5674,174
PSCO,"2/16/2023 6 p.m. MST",5861,5555,6084,223
PSCO,"2/16/2023 7 p.m. MST",6095,5815,6313,218
PSCO,"2/16/2023 8 p.m. MST",6048,5769,6219,171
PSCO,"2/16/2023 9 p.m. MST",5922,5627,6249,327
PSCO,"2/16/2023 10 p.m. MST",5674,5428,6090,416
PSCO,"2/16/2023 11 p.m. MST",5399,5147,5850,451
PSCO,"2/17/2023 12 a.m. MST",5007,4921,5541,534
PSCO,"2/17/2023 1 a.m. MST",4999,4805,5519,520
PSCO,"2/17/2023 2 a.m. MST",4924,4694,5371,447
PSCO,"2/17/2023 3 a.m. MST",4887,4697,5387,500
PSCO,"2/17/2023 4 a.m. MST",4932,4764,5426,494
PSCO,"2/17/2023 5 a.m. MST",5019,4858,5512,493
PSCO,"2/17/2023 6 a.m. MST",5257,5055,5705,448
PSCO,"2/17/2023 7 a.m. MST",5587,5404,5988,401
PSCO,"2/17/2023 8 a.m. MST",5719,5516,6068,349
PSCO,"2/17/2023 9 a.m. MST",5556,5347,5819,263
PSCO,"2/17/2023 10 a.m. MST",5338,5028,5502,164
PSCO,"2/17/2023 11 a.m. MST",5256,4854,5392,136
PSCO,"2/17/2023 12 p.m. MST",5131,4724,5258,127
PSCO,"2/17/2023 1 p.m. MST",4932,4600,4929,-3
PSCO,"2/17/2023 2 p.m. MST",4807,4535,4809,2
PSCO,"2/17/2023 3 p.m. MST",4756,4529,4743,-13
PSCO,"2/17/2023 4 p.m. MST",4773,4579,4927,154
PSCO,"2/17/2023 5 p.m. MST",5010,4774,5090,80
PSCO,"2/17/2023 6 p.m. MST",5362,5061,5494,132
PSCO,"2/17/2023 7 p.m. MST",5536,5265,5894,358
PSCO,"2/17/2023 8 p.m. MST",5476,5231,5819,343
PSCO,"2/17/2023 9 p.m. MST",5361,5108,5681,320
PSCO,"2/17/2023 10 p.m. MST",5200,4974,5567,367
PSCO,"2/17/2023 11 p.m. MST",4955,4800,5389,434
PSCO,"2/18/2023 12 a.m. MST",4735,4585,5122,387
PSCO,"2/18/2023 1 a.m. MST",4593,4426,5033,440
PSCO,"2/18/2023 2 a.m. MST",4446,4372,4977,531
PSCO,"2/18/2023 3 a.m. MST",4452,4370,4959,507
PSCO,"2/18/2023 4 a.m. MST",4497,4388,5059,562
PSCO,"2/18/2023 5 a.m. MST",4558,4493,5161,603
PSCO,"2/18/2023 6 a.m. MST",4668,4617,5182,514
PSCO,"2/18/2023 7 a.m. MST",4866,4838,5496,630
PSCO,"2/18/2023 8 a.m. MST",4993,4873,5534,541
PSCO,"2/18/2023 9 a.m. MST",5054,4740,5590,536
PSCO,"2/18/2023 10 a.m. MST",4894,4613,5249,355
PSCO,"2/18/2023 11 a.m. MST",4722,4502,4921,199
PSCO,"2/18/2023 12 p.m. MST",4523,4381,4658,135
PSCO,"2/18/2023 1 p.m. MST",4559,4266,4546,-13
PSCO,"2/18/2023 2 p.m. MST",4515,4214,4531,16
PSCO,"2/18/2023 3 p.m. MST",4372,4256,4466,94
PSCO,"2/18/2023 4 p.m. MST",4371,4378,4409,38
PSCO,"2/18/2023 5 p.m. MST",4592,4674,4583,-9
PSCO,"2/18/2023 6 p.m. MST",4961,4897,5136,175
PSCO,"2/18/2023 7 p.m. MST",5185,5148,5484,299
PSCO,"2/18/2023 8 p.m. MST",5178,5091,5421,243
PSCO,"2/18/2023 9 p.m. MST",5119,5022,5326,207
PSCO,"2/18/2023 10 p.m. MST",4922,4871,5258,336
PSCO,"2/18/2023 11 p.m. MST",4782,4686,5140,358
PSCO,"2/19/2023 12 a.m. MST",4553,4532,4891,338
PSCO,"2/19/2023 1 a.m. MST",4451,4436,4764,313
PSCO,"2/19/2023 2 a.m. MST",4353,4438,4713,360
PSCO,"2/19/2023 3 a.m. MST",4328,4376,4671,343
PSCO,"2/19/2023 4 a.m. MST",4318,4330,4687,369
PSCO,"2/19/2023 5 a.m. MST",4341,4391,4634,293
PSCO,"2/19/2023 6 a.m. MST",4437,4481,4766,329
PSCO,"2/19/2023 7 a.m. MST",4577,4613,4783,206
PSCO,"2/19/2023 8 a.m. MST",4591,4635,4947,356
PSCO,"2/19/2023 9 a.m. MST",4451,4551,4885,434
PSCO,"2/19/2023 10 a.m. MST",4331,4410,4767,436
PSCO,"2/19/2023 11 a.m. MST",4278,4298,4778,500
PSCO,"2/19/2023 12 p.m. MST",4289,4134,4706,417
PSCO,"2/19/2023 1 p.m. MST",4271,4063,4645,374
PSCO,"2/19/2023 2 p.m. MST",4238,4232,4608,370
PSCO,"2/19/2023 3 p.m. MST",4230,4397,4641,411
PSCO,"2/19/2023 4 p.m. MST",4341,4517,4700,359
PSCO,"2/19/2023 5 p.m. MST",4578,4807,4906,328
PSCO,"2/19/2023 6 p.m. MST",5036,5129,5240,204
PSCO,"2/19/2023 7 p.m. MST",5291,5303,5376,85
PSCO,"2/19/2023 8 p.m. MST",5254,5188,5365,111
PSCO,"2/19/2023 9 p.m. MST",5149,5167,5268,119
PSCO,"2/19/2023 10 p.m. MST",4957,4939,5221,264
PSCO,"2/19/2023 11 p.m. MST",4697,4691,4833,136
PSCO,"2/20/2023 12 a.m. MST",4474,4449,4727,253
PSCO,"2/20/2023 1 a.m. MST",4309,4349,4563,254
PSCO,"2/20/2023 2 a.m. MST",4243,4394,4380,137
PSCO,"2/20/2023 3 a.m. MST",4218,4365,4384,166
PSCO,"2/20/2023 4 a.m. MST",4225,4344,4350,125
PSCO,"2/20/2023 5 a.m. MST",4327,4426,4593,266
PSCO,"2/20/2023 6 a.m. MST",4577,4698,4916,339
PSCO,"2/20/2023 7 a.m. MST",4862,4850,5148,286
PSCO,"2/20/2023 8 a.m. MST",4863,4911,5162,299
PSCO,"2/20/2023 9 a.m. MST",4959,4869,5183,224
PSCO,"2/20/2023 10 a.m. MST",4999,4639,5282,283
PSCO,"2/20/2023 11 a.m. MST",5018,4527,5187,169
PSCO,"2/20/2023 12 p.m. MST",5016,4387,5222,206
PSCO,"2/20/2023 1 p.m. MST",4786,4261,5035,249
PSCO,"2/20/2023 2 p.m. MST",4836,4310,5063,227
PSCO,"2/20/2023 3 p.m. MST",4728,4360,4931,203
PSCO,"2/20/2023 4 p.m. MST",4761,4486,4922,161
PSCO,"2/20/2023 5 p.m. MST",4942,4777,5126,184
PSCO,"2/20/2023 6 p.m. MST",5262,5042,5566,304
PSCO,"2/20/2023 7 p.m. MST",5463,5379,5682,219
PSCO,"2/20/2023 8 p.m. MST",5372,5248,5778,406
PSCO,"2/20/2023 9 p.m. MST",5184,5141,5599,415
PSCO,"2/20/2023 10 p.m. MST",5082,4883,5419,337
PSCO,"2/20/2023 11 p.m. MST",4694,4612,5139,445
PSCO,"2/21/2023 12 a.m. MST",4445,4445,5168,723
PSCO,"2/21/2023 1 a.m. MST",4301,4275,4992,691
PSCO,"2/21/2023 2 a.m. MST",4229,4203,4841,612
PSCO,"2/21/2023 3 a.m. MST",4210,4165,4783,573
PSCO,"2/21/2023 4 a.m. MST",4236,4221,4805,569
PSCO,"2/21/2023 5 a.m. MST",4380,4347,4960,580
PSCO,"2/21/2023 6 a.m. MST",4631,4670,5185,554
PSCO,"2/21/2023 7 a.m. MST",5026,5024,5140,114
PSCO,"2/21/2023 8 a.m. MST",5102,5165,5254,152
PSCO,"2/21/2023 9 a.m. MST",4909,5041,4907,-2
PSCO,"2/21/2023 10 a.m. MST",4648,4900,4652,4
PSCO,"2/21/2023 11 a.m. MST",4530,4759,4489,-41
PSCO,"2/21/2023 12 p.m. MST",4458,4665,4446,-12
PSCO,"2/21/2023 1 p.m. MST",4385,4623,4346,-39
PSCO,"2/21/2023 2 p.m. MST",4417,4629,4392,-25
PSCO,"2/21/2023 3 p.m. MST",4482,4689,4459,-23
PSCO,"2/21/2023 4 p.m. MST",4632,4807,4715,83
PSCO,"2/21/2023 5 p.m. MST",4861,5015,4856,-5
PSCO,"2/21/2023 6 p.m. MST",5153,5172,5338,185
PSCO,"2/21/2023 7 p.m. MST",5344,5362,5588,244
PSCO,"2/21/2023 8 p.m. MST",5263,5304,5336,73
PSCO,"2/21/2023 9 p.m. MST",5093,5146,5177,84
PSCO,"2/21/2023 10 p.m. MST",4821,4926,4893,72
PSCO,"2/21/2023 11 p.m. MST",4522,4718,4699,177
PSCO,"2/22/2023 12 a.m. MST",4289,4467,4583,294
PSCO,"2/22/2023 1 a.m. MST",4188,4393,4337,149
PSCO,"2/22/2023 2 a.m. MST",4215,4182,4416,201
PSCO,"2/22/2023 3 a.m. MST",4260,4132,4477,217
PSCO,"2/22/2023 4 a.m. MST",4366,4261,4563,197
PSCO,"2/22/2023 5 a.m. MST",4501,4534,4711,210
PSCO,"2/22/2023 6 a.m. MST",4832,4786,5170,338
PSCO,"2/22/2023 7 a.m. MST",5265,5338,5647,382
PSCO,"2/22/2023 8 a.m. MST",5565,5516,5826,261
PSCO,"2/22/2023 9 a.m. MST",5706,5582,5926,220
PSCO,"2/22/2023 10 a.m. MST",5832,5648,5914,82
PSCO,"2/22/2023 11 a.m. MST",5944,5704,5907,-37
PSCO,"2/22/2023 12 p.m. MST",5978,5709,6033,55
PSCO,"2/22/2023 1 p.m. MST",5970,5742,5948,-22
PSCO,"2/22/2023 2 p.m. MST",5961,5732,5889,-72
PSCO,"2/22/2023 3 p.m. MST",5973,5767,5965,-8
PSCO,"2/22/2023 4 p.m. MST",6022,5788,5973,-49
PSCO,"2/22/2023 5 p.m. MST",6122,5882,6117,-5
PSCO,"2/22/2023 6 p.m. MST",6411,5992,6603,192
PSCO,"2/22/2023 7 p.m. MST",6522,6058,6745,223
PSCO,"2/22/2023 8 p.m. MST",6411,5984,6601,190
PSCO,"2/22/2023 9 p.m. MST",6214,5858,6427,213
PSCO,"2/22/2023 10 p.m. MST",6015,5631,6204,189
PSCO,"2/22/2023 11 p.m. MST",5693,5404,6020,327
PSCO,"2/23/2023 12 a.m. MST",5489,5208,5778,289
PSCO,"2/23/2023 1 a.m. MST",5260,5083,5489,229
PSCO,"2/23/2023 2 a.m. MST",4927,4967,5267,340
PSCO,"2/23/2023 3 a.m. MST",4987,5031,5284,297
PSCO,"2/23/2023 4 a.m. MST",5187,5038,5509,322
PSCO,"2/23/2023 5 a.m. MST",5374,5184,5782,408
PSCO,"2/23/2023 6 a.m. MST",5788,5400,5921,133
PSCO,"2/23/2023 7 a.m. MST",5919,5773,6001,82
PSCO,"2/23/2023 8 a.m. MST",6066,5985,6187,121
PSCO,"2/23/2023 9 a.m. MST",6057,5932,6045,-12
PSCO,"2/23/2023 10 a.m. MST",5876,5868,5747,-129
PSCO,"2/23/2023 11 a.m. MST",5821,5812,5419,-402
PSCO,"2/23/2023 12 p.m. MST",5737,5747,5424,-313
PSCO,"2/23/2023 1 p.m. MST",5671,5663,5411,-260
PSCO,"2/23/2023 2 p.m. MST",5666,5586,5565,-101
PSCO,"2/23/2023 3 p.m. MST",5584,5544,5525,-59
PSCO,"2/23/2023 4 p.m. MST",5677,5566,5674,-3
PSCO,"2/23/2023 5 p.m. MST",6164,5658,6253,89
PSCO,"2/23/2023 6 p.m. MST",6192,6004,6548,356
PSCO,"2/23/2023 7 p.m. MST",6351,6126,6790,439
PSCO,"2/23/2023 8 p.m. MST",6259,6053,6725,466
PSCO,"2/23/2023 9 p.m. MST",6078,5881,6566,488
PSCO,"2/23/2023 10 p.m. MST",5876,5584,6559,683
PSCO,"2/23/2023 11 p.m. MST",5577,5289,6275,698
PSCO,"2/24/2023 12 a.m. MST",5304,5072,6023,719
PSCO,"2/24/2023 1 a.m. MST",5155,4935,6027,872
PSCO,"2/24/2023 2 a.m. MST",5114,4859,5887,773
PSCO,"2/24/2023 3 a.m. MST",5099,4861,5914,815
PSCO,"2/24/2023 4 a.m. MST",5099,4879,5921,822
PSCO,"2/24/2023 5 a.m. MST",5196,4989,6031,835
PSCO,"2/24/2023 6 a.m. MST",5491,5224,6426,935
PSCO,"2/24/2023 7 a.m. MST",5849,5651,6876,1027
PSCO,"2/24/2023 8 a.m. MST",5966,5839,6941,975
PSCO,"2/24/2023 9 a.m. MST",5905,5704,7005,1100
PSCO,"2/24/2023 10 a.m. MST",5785,5560,6531,746
PSCO,"2/24/2023 11 a.m. MST",5673,5430,6331,658
PSCO,"2/24/2023 12 p.m. MST",5572,5304,6211,639
PSCO,"2/24/2023 1 p.m. MST",5360,5104,6081,721
PSCO,"2/24/2023 2 p.m. MST",5175,5030,5898,723
PSCO,"2/24/2023 3 p.m. MST",5108,4992,5579,471
PSCO,"2/24/2023 4 p.m. MST",5078,4970,5586,508
PSCO,"2/24/2023 5 p.m. MST",5267,5147,5605,338
PSCO,"2/24/2023 6 p.m. MST",5572,5401,5859,287
PSCO,"2/24/2023 7 p.m. MST",5725,5589,6102,377
PSCO,"2/24/2023 8 p.m. MST",5588,5522,6113,525
PSCO,"2/24/2023 9 p.m. MST",5399,5368,5942,543
PSCO,"2/24/2023 10 p.m. MST",5486,5222,6080,594
PSCO,"2/24/2023 11 p.m. MST",5130,5002,5611,481
PSCO,"2/25/2023 12 a.m. MST",4903,4729,5424,521
PSCO,"2/25/2023 1 a.m. MST",4744,4784,5331,587
PSCO,"2/25/2023 2 a.m. MST",4650,4702,5142,492
PSCO,"2/25/2023 3 a.m. MST",4596,4613,5052,456
PSCO,"2/25/2023 4 a.m. MST",4569,4568,4972,403
PSCO,"2/25/2023 5 a.m. MST",4613,4627,5114,501
PSCO,"2/25/2023 6 a.m. MST",4768,4748,5132,364
PSCO,"2/25/2023 7 a.m. MST",4927,4904,5190,263
PSCO,"2/25/2023 8 a.m. MST",4963,4948,5182,219
PSCO,"2/25/2023 9 a.m. MST",4824,4838,5132,308
PSCO,"2/25/2023 10 a.m. MST",4680,4690,5063,383
PSCO,"2/25/2023 11 a.m. MST",4538,4565,4798,260
PSCO,"2/25/2023 12 p.m. MST",4383,4426,4731,348
PSCO,"2/25/2023 1 p.m. MST",4307,4308,4696,389
PSCO,"2/25/2023 2 p.m. MST",4184,4242,4528,344
PSCO,"2/25/2023 3 p.m. MST",4177,4227,4497,320
PSCO,"2/25/2023 4 p.m. MST",4299,4327,4600,301
PSCO,"2/25/2023 5 p.m. MST",4556,4556,4842,286
PSCO,"2/25/2023 6 p.m. MST",4898,4876,5256,358
PSCO,"2/25/2023 7 p.m. MST",5131,5101,5519,388
PSCO,"2/25/2023 8 p.m. MST",5041,5128,5319,278
PSCO,"2/25/2023 9 p.m. MST",5004,5046,5302,298
PSCO,"2/25/2023 10 p.m. MST",4871,4883,5077,206
PSCO,"2/25/2023 11 p.m. MST",4683,4689,4957,274
PSCO,"2/26/2023 12 a.m. MST",4493,4551,4712,219
PSCO,"2/26/2023 1 a.m. MST",4316,4400,4543,227
PSCO,"2/26/2023 2 a.m. MST",4249,4398,4519,270
PSCO,"2/26/2023 3 a.m. MST",4185,4278,4479,294
PSCO,"2/26/2023 4 a.m. MST",4198,4293,4490,292
PSCO,"2/26/2023 5 a.m. MST",4247,4311,4452,205
PSCO,"2/26/2023 6 a.m. MST",4326,4387,4649,323
PSCO,"2/26/2023 7 a.m. MST",4474,4553,4809,335
PSCO,"2/26/2023 8 a.m. MST",4450,4548,4844,394
PSCO,"2/26/2023 9 a.m. MST",4352,4440,4664,312
PSCO,"2/26/2023 10 a.m. MST",4263,4379,4686,423
PSCO,"2/26/2023 11 a.m. MST",4234,4301,4611,377
PSCO,"2/26/2023 12 p.m. MST",4258,4205,4700,442
PSCO,"2/26/2023 1 p.m. MST",4280,4071,4633,353
PSCO,"2/26/2023 2 p.m. MST",4276,4040,4730,454
PSCO,"2/26/2023 3 p.m. MST",4347,4066,4907,560
PSCO,"2/26/2023 4 p.m. MST",4502,4224,4906,404
PSCO,"2/26/2023 5 p.m. MST",4734,4534,5073,339
PSCO,"2/26/2023 6 p.m. MST",4949,4790,5418,469
PSCO,"2/26/2023 7 p.m. MST",5266,5220,5734,468
PSCO,"2/26/2023 8 p.m. MST",5242,5067,5616,374
PSCO,"2/26/2023 9 p.m. MST",5126,5027,5522,396
PSCO,"2/26/2023 10 p.m. MST",4851,4833,5089,238
PSCO,"2/26/2023 11 p.m. MST",4589,4618,4844,255
PSCO,"2/27/2023 12 a.m. MST",4397,4396,4671,274
PSCO,"2/27/2023 1 a.m. MST",4244,4312,4413,169
PSCO,"2/27/2023 2 a.m. MST",4130,4229,4355,225
PSCO,"2/27/2023 3 a.m. MST",4096,4205,4358,262
PSCO,"2/27/2023 4 a.m. MST",4218,4280,4446,228
PSCO,"2/27/2023 5 a.m. MST",4362,4422,4628,266
PSCO,"2/27/2023 6 a.m. MST",4651,4713,4993,342
PSCO,"2/27/2023 7 a.m. MST",5052,5120,5351,299
PSCO,"2/27/2023 8 a.m. MST",5085,5185,5474,389
PSCO,"2/27/2023 9 a.m. MST",4924,5000,5215,291
PSCO,"2/27/2023 10 a.m. MST",4781,4818,5033,252
PSCO,"2/27/2023 11 a.m. MST",4643,4644,4901,258
PSCO,"2/27/2023 12 p.m. MST",4540,4542,4945,405
PSCO,"2/27/2023 1 p.m. MST",4459,4481,4905,446
PSCO,"2/27/2023 2 p.m. MST",4476,4478,4868,392
PSCO,"2/27/2023 3 p.m. MST",4491,4502,4911,420
PSCO,"2/27/2023 4 p.m. MST",4587,4589,5172,585
PSCO,"2/27/2023 5 p.m. MST",4797,4814,5247,450
PSCO,"2/27/2023 6 p.m. MST",5151,5054,5481,330
PSCO,"2/27/2023 7 p.m. MST",5430,5342,5832,402
PSCO,"2/27/2023 8 p.m. MST",5355,5337,5791,436
PSCO,"2/27/2023 9 p.m. MST",5157,5207,5580,423
PSCO,"2/27/2023 10 p.m. MST",4924,4995,5294,370
PSCO,"2/27/2023 11 p.m. MST",4653,4720,5109,456
PSCO,"2/28/2023 12 a.m. MST",4458,4459,4839,381
PSCO,"2/28/2023 1 a.m. MST",,4370,,
PSCO,"2/28/2023 2 a.m. MST",,4296,,
PSCO,"2/28/2023 3 a.m. MST",,4277,,
PSCO,"2/28/2023 4 a.m. MST",,4329,,
PSCO,"2/28/2023 5 a.m. MST",,4447,,
PSCO,"2/28/2023 6 a.m. MST",,4739,,
PSCO,"2/28/2023 7 a.m. MST",,5139,,
PSCO,"2/28/2023 8 a.m. MST",,5192,,
PSCO,"2/28/2023 9 a.m. MST",,5032,,
PSCO,"2/28/2023 10 a.m. MST",,4791,,
PSCO,"2/28/2023 11 a.m. MST",,4590,,
PSCO,"2/28/2023 12 p.m. MST",,4518,,
PSCO,"2/28/2023 1 p.m. MST",,4616,,
PSCO,"2/28/2023 2 p.m. MST",,4718,,
PSCO,"2/28/2023 3 p.m. MST",,4748,,
PSCO,"2/28/2023 4 p.m. MST",,4845,,
PSCO,"2/28/2023 5 p.m. MST",,5014,,
PSCO,"2/28/2023 6 p.m. MST",,5233,,
PSCO,"2/28/2023 7 p.m. MST",,5424,,
PSCO,"2/28/2023 8 p.m. MST",,5408,,
PSCO,"2/28/2023 9 p.m. MST",,5248,,
PSCO,"2/28/2023 10 p.m. MST",,5068,,
PSCO,"2/28/2023 11 p.m. MST",,4835,,
PSCO,"3/1/2023 12 a.m. MST",,4589,,
