"BA Code","Timestamp (Hour Ending)","Demand (MWh)","Demand Forecast (MWh)","Net Generation (MWh)","Total Interchange (MWh)"
PSCO,"1/1/2023 12 a.m. MST",4564,4532,4779,215
PSCO,"1/1/2023 1 a.m. MST",4414,4453,4606,192
PSCO,"1/1/2023 2 a.m. MST",4312,4378,4555,243
PSCO,"1/1/2023 3 a.m. MST",4214,4240,4634,420
PSCO,"1/1/2023 4 a.m. MST",4140,4196,4548,408
PSCO,"1/1/2023 5 a.m. MST",4136,4253,4567,431
PSCO,"1/1/2023 6 a.m. MST",4209,4278,4470,261
PSCO,"1/1/2023 7 a.m. MST",4379,4439,4534,155
PSCO,"1/1/2023 8 a.m. MST",4398,4633,4661,263
PSCO,"1/1/2023 9 a.m. MST",4489,4569,4667,178
PSCO,"1/1/2023 10 a.m. MST",4546,4468,4675,129
PSCO,"1/1/2023 11 a.m. MST",4561,4445,4682,121
PSCO,"1/1/2023 12 p.m. MST",4524,4432,4644,120
PSCO,"1/1/2023 1 p.m. MST",4552,4347,4596,44
PSCO,"1/1/2023 2 p.m. MST",4572,4635,4558,-14
PSCO,"1/1/2023 3 p.m. MST",4645,4729,4641,-4
PSCO,"1/1/2023 4 p.m. MST",4778,4841,4814,36
PSCO,"1/1/2023 5 p.m. MST",5090,5048,5327,237
PSCO,"1/1/2023 6 p.m. MST",5388,5391,5698,310
PSCO,"1/1/2023 7 p.m. MST",5358,5384,5654,296
PSCO,"1/1/2023 8 p.m. MST",5207,5200,5383,176
PSCO,"1/1/2023 9 p.m. MST",5085,5139,5262,177
PSCO,"1/1/2023 10 p.m. MST",4893,4969,5148,255
PSCO,"1/1/2023 11 p.m. MST",4638,4666,4919,281
PSCO,"1/2/2023 12 a.m. MST",4501,4609,4712,211
PSCO,"1/2/2023 1 a.m. MST",4345,4378,4614,269
PSCO,"1/2/2023 2 a.m. MST",4242,4383,4479,237
PSCO,"1/2/2023 3 a.m. MST",4203,4395,4417,214
PSCO,"1/2/2023 4 a.m. MST",4253,4393,4443,190
PSCO,"1/2/2023 5 a.m. MST",4335,4327,4494,159
PSCO,"1/2/2023 6 a.m. MST",4516,4452,4686,170
PSCO,"1/2/2023 7 a.m. MST",4737,4637,4898,161
PSCO,"1/2/2023 8 a.m. MST",4865,4876,5094,229
PSCO,"1/2/2023 9 a.m. MST",5041,4997,5182,141
PSCO,"1/2/2023 10 a.m. MST",5181,5166,5296,115
PSCO,"1/2/2023 11 a.m. MST",5283,5226,5457,174
PSCO,"1/2/2023 12 p.m. MST",5349,5357,5421,72
PSCO,"1/2/2023 1 p.m. MST",5425,5408,5372,-53
PSCO,"1/2/2023 2 p.m. MST",5474,5392,5242,-232
PSCO,"1/2/2023 3 p.m. MST",5456,5428,5195,-261
PSCO,"1/2/2023 4 p.m. MST",5537,5517,5205,-332
PSCO,"1/2/2023 5 p.m. MST",5751,5678,5422,-329
PSCO,"1/2/2023 6 p.m. MST",6021,5898,5737,-284
PSCO,"1/2/2023 7 p.m. MST",5905,5927,5734,-171
PSCO,"1/2/2023 8 p.m. MST",5743,5746,5385,-358
PSCO,"1/2/2023 9 p.m. MST",5589,5512,5414,-175
PSCO,"1/2/2023 10 p.m. MST",5315,5212,5695,380
PSCO,"1/2/2023 11 p.m. MST",4974,4925,5413,439
PSCO,"1/3/2023 12 a.m. MST",4781,4873,5339,558
PSCO,"1/3/2023 1 a.m. MST",4621,4657,5155,534
PSCO,"1/3/2023 2 a.m. MST",4550,4640,4997,447
PSCO,"1/3/2023 3 a.m. MST",4516,4555,4944,428
PSCO,"1/3/2023 4 a.m. MST",4552,4656,4999,447
PSCO,"1/3/2023 5 a.m. MST",4696,4777,5118,422
PSCO,"1/3/2023 6 a.m. MST",4936,5015,5380,444
PSCO,"1/3/2023 7 a.m. MST",5282,5411,5775,493
PSCO,"1/3/2023 8 a.m. MST",5458,5580,6025,567
PSCO,"1/3/2023 9 a.m. MST",5488,5573,6035,547
PSCO,"1/3/2023 10 a.m. MST",5483,5428,6045,562
PSCO,"1/3/2023 11 a.m. MST",5521,5307,5944,423
PSCO,"1/3/2023 12 p.m. MST",5495,5377,5949,454
PSCO,"1/3/2023 1 p.m. MST",5519,5407,5834,315
PSCO,"1/3/2023 2 p.m. MST",5542,5416,5575,33
PSCO,"1/3/2023 3 p.m. MST",5491,5327,5544,53
PSCO,"1/3/2023 4 p.m. MST",5494,5453,5483,-11
PSCO,"1/3/2023 5 p.m. MST",5775,5714,5719,-56
PSCO,"1/3/2023 6 p.m. MST",6102,6096,6057,-45
PSCO,"1/3/2023 7 p.m. MST",6068,6044,6087,19
PSCO,"1/3/2023 8 p.m. MST",5860,5904,5939,79
PSCO,"1/3/2023 9 p.m. MST",5655,5755,5976,321
PSCO,"1/3/2023 10 p.m. MST",5456,5522,5884,428
PSCO,"1/3/2023 11 p.m. MST",5109,5218,5466,357
PSCO,"1/4/2023 12 a.m. MST",5006,4901,5381,375
PSCO,"1/4/2023 1 a.m. MST",4841,4743,5261,420
PSCO,"1/4/2023 2 a.m. MST",4831,4688,5322,491
PSCO,"1/4/2023 3 a.m. MST",4757,4722,5266,509
PSCO,"1/4/2023 4 a.m. MST",4741,4773,5338,597
PSCO,"1/4/2023 5 a.m. MST",4857,4868,5492,635
PSCO,"1/4/2023 6 a.m. MST",5069,5147,5718,649
PSCO,"1/4/2023 7 a.m. MST",5411,5509,5915,504
PSCO,"1/4/2023 8 a.m. MST",5599,5674,6234,635
PSCO,"1/4/2023 9 a.m. MST",5587,5503,6289,702
PSCO,"1/4/2023 10 a.m. MST",5524,5272,6201,677
PSCO,"1/4/2023 11 a.m. MST",5479,5123,6072,593
PSCO,"1/4/2023 12 p.m. MST",5370,5024,5950,580
PSCO,"1/4/2023 1 p.m. MST",5348,5016,5781,433
PSCO,"1/4/2023 2 p.m. MST",5218,4959,5798,580
PSCO,"1/4/2023 3 p.m. MST",5160,5007,5785,625
PSCO,"1/4/2023 4 p.m. MST",5252,5143,5738,486
PSCO,"1/4/2023 5 p.m. MST",5546,5558,5890,344
PSCO,"1/4/2023 6 p.m. MST",5982,5877,6215,233
PSCO,"1/4/2023 7 p.m. MST",5956,5913,6190,234
PSCO,"1/4/2023 8 p.m. MST",5832,5830,6083,251
PSCO,"1/4/2023 9 p.m. MST",5740,5659,5984,244
PSCO,"1/4/2023 10 p.m. MST",5487,5471,5676,189
PSCO,"1/4/2023 11 p.m. MST",5197,5170,5433,236
PSCO,"1/5/2023 12 a.m. MST",4977,4835,5202,225
PSCO,"1/5/2023 1 a.m. MST",4866,4707,5220,354
PSCO,"1/5/2023 2 a.m. MST",4789,4637,5178,389
PSCO,"1/5/2023 3 a.m. MST",4729,4599,5066,337
PSCO,"1/5/2023 4 a.m. MST",4778,4630,5053,275
PSCO,"1/5/2023 5 a.m. MST",4909,4735,5251,342
PSCO,"1/5/2023 6 a.m. MST",5203,5030,5468,265
PSCO,"1/5/2023 7 a.m. MST",5550,5433,5623,73
PSCO,"1/5/2023 8 a.m. MST",5676,5624,5784,108
PSCO,"1/5/2023 9 a.m. MST",5693,5617,5758,65
PSCO,"1/5/2023 10 a.m. MST",5713,5493,5882,169
PSCO,"1/5/2023 11 a.m. MST",5703,5210,6043,340
PSCO,"1/5/2023 12 p.m. MST",5597,5140,5951,354
PSCO,"1/5/2023 1 p.m. MST",5478,5122,5899,421
PSCO,"1/5/2023 2 p.m. MST",5399,5072,5816,417
PSCO,"1/5/2023 3 p.m. MST",5227,5040,5665,438
PSCO,"1/5/2023 4 p.m. MST",5255,5180,5678,423
PSCO,"1/5/2023 5 p.m. MST",5588,5430,5913,325
PSCO,"1/5/2023 6 p.m. MST",6008,5803,6278,270
PSCO,"1/5/2023 7 p.m. MST",6000,5729,6288,288
PSCO,"1/5/2023 8 p.m. MST",5888,5618,6164,276
PSCO,"1/5/2023 9 p.m. MST",5729,5495,6014,285
PSCO,"1/5/2023 10 p.m. MST",5480,5269,5776,296
PSCO,"1/5/2023 11 p.m. MST",5139,4983,5420,281
PSCO,"1/6/2023 12 a.m. MST",4938,4734,5135,197
PSCO,"1/6/2023 1 a.m. MST",4730,4601,4761,31
PSCO,"1/6/2023 2 a.m. MST",4635,4502,4664,29
PSCO,"1/6/2023 3 a.m. MST",4614,4506,4643,29
PSCO,"1/6/2023 4 a.m. MST",4630,4569,4640,10
PSCO,"1/6/2023 5 a.m. MST",4759,4688,4823,64
PSCO,"1/6/2023 6 a.m. MST",4993,4907,5112,119
PSCO,"1/6/2023 7 a.m. MST",5360,5308,5602,242
PSCO,"1/6/2023 8 a.m. MST",5497,5504,5846,349
PSCO,"1/6/2023 9 a.m. MST",5521,5466,5829,308
PSCO,"1/6/2023 10 a.m. MST",5468,5339,5693,225
PSCO,"1/6/2023 11 a.m. MST",5422,5274,5591,169
PSCO,"1/6/2023 12 p.m. MST",5337,5177,5554,217
PSCO,"1/6/2023 1 p.m. MST",5288,5167,5472,184
PSCO,"1/6/2023 2 p.m. MST",5170,5184,5403,233
PSCO,"1/6/2023 3 p.m. MST",5125,5245,5487,362
PSCO,"1/6/2023 4 p.m. MST",5271,5426,5439,168
PSCO,"1/6/2023 5 p.m. MST",5367,5688,5599,232
PSCO,"1/6/2023 6 p.m. MST",5797,5965,5990,193
PSCO,"1/6/2023 7 p.m. MST",5724,5568,5913,189
PSCO,"1/6/2023 8 p.m. MST",5596,5433,5745,149
PSCO,"1/6/2023 9 p.m. MST",5459,5276,5642,183
PSCO,"1/6/2023 10 p.m. MST",5303,5149,5616,313
PSCO,"1/6/2023 11 p.m. MST",5036,4922,5464,428
PSCO,"1/7/2023 12 a.m. MST",4816,4696,5360,544
PSCO,"1/7/2023 1 a.m. MST",4692,4520,5285,593
PSCO,"1/7/2023 2 a.m. MST",4521,4456,5226,705
PSCO,"1/7/2023 3 a.m. MST",4424,4429,5176,752
PSCO,"1/7/2023 4 a.m. MST",4466,4424,5122,656
PSCO,"1/7/2023 5 a.m. MST",4563,4435,5151,588
PSCO,"1/7/2023 6 a.m. MST",4696,4514,5194,498
PSCO,"1/7/2023 7 a.m. MST",4903,4771,5299,396
PSCO,"1/7/2023 8 a.m. MST",4979,4937,5366,387
PSCO,"1/7/2023 9 a.m. MST",4981,4956,5338,357
PSCO,"1/7/2023 10 a.m. MST",4900,4875,5230,330
PSCO,"1/7/2023 11 a.m. MST",4740,4802,4995,255
PSCO,"1/7/2023 12 p.m. MST",4724,4693,4976,252
PSCO,"1/7/2023 1 p.m. MST",4621,4513,4889,268
PSCO,"1/7/2023 2 p.m. MST",4561,4467,4805,244
PSCO,"1/7/2023 3 p.m. MST",4537,4516,4813,276
PSCO,"1/7/2023 4 p.m. MST",4641,4694,4895,254
PSCO,"1/7/2023 5 p.m. MST",4969,4904,5077,108
PSCO,"1/7/2023 6 p.m. MST",5384,5396,5493,109
PSCO,"1/7/2023 7 p.m. MST",5449,5412,5591,142
PSCO,"1/7/2023 8 p.m. MST",5410,5344,5532,122
PSCO,"1/7/2023 9 p.m. MST",5332,5236,5465,133
PSCO,"1/7/2023 10 p.m. MST",5153,5121,5427,274
PSCO,"1/7/2023 11 p.m. MST",4965,5013,5257,292
PSCO,"1/8/2023 12 a.m. MST",4837,4811,5103,266
PSCO,"1/8/2023 1 a.m. MST",4670,4711,5013,343
PSCO,"1/8/2023 2 a.m. MST",4508,4610,4803,295
PSCO,"1/8/2023 3 a.m. MST",4435,4555,4678,243
PSCO,"1/8/2023 4 a.m. MST",4447,4482,4682,235
PSCO,"1/8/2023 5 a.m. MST",4540,4544,4776,236
PSCO,"1/8/2023 6 a.m. MST",4643,4649,4804,161
PSCO,"1/8/2023 7 a.m. MST",4807,4769,4915,108
PSCO,"1/8/2023 8 a.m. MST",4858,4861,5071,213
PSCO,"1/8/2023 9 a.m. MST",4910,4708,5194,284
PSCO,"1/8/2023 10 a.m. MST",4888,4555,5173,285
PSCO,"1/8/2023 11 a.m. MST",4709,4460,4958,249
PSCO,"1/8/2023 12 p.m. MST",4647,4384,4886,239
PSCO,"1/8/2023 1 p.m. MST",4590,4299,4812,222
PSCO,"1/8/2023 2 p.m. MST",4546,4460,4731,185
PSCO,"1/8/2023 3 p.m. MST",4500,4599,4671,171
PSCO,"1/8/2023 4 p.m. MST",4700,4737,4721,21
PSCO,"1/8/2023 5 p.m. MST",5108,5085,5207,99
PSCO,"1/8/2023 6 p.m. MST",5480,5385,5617,137
PSCO,"1/8/2023 7 p.m. MST",5524,5595,5719,195
PSCO,"1/8/2023 8 p.m. MST",5511,5344,5692,181
PSCO,"1/8/2023 9 p.m. MST",5283,5332,5512,229
PSCO,"1/8/2023 10 p.m. MST",5014,5065,5306,292
PSCO,"1/8/2023 11 p.m. MST",4783,4763,5082,299
PSCO,"1/9/2023 12 a.m. MST",4608,4580,5038,430
PSCO,"1/9/2023 1 a.m. MST",4403,4458,4821,418
PSCO,"1/9/2023 2 a.m. MST",4292,4431,4714,422
PSCO,"1/9/2023 3 a.m. MST",4278,4427,4680,402
PSCO,"1/9/2023 4 a.m. MST",4317,4505,4688,371
PSCO,"1/9/2023 5 a.m. MST",4436,4642,4822,386
PSCO,"1/9/2023 6 a.m. MST",4733,4870,5038,305
PSCO,"1/9/2023 7 a.m. MST",5176,5245,5496,320
PSCO,"1/9/2023 8 a.m. MST",5374,5445,5694,320
PSCO,"1/9/2023 9 a.m. MST",5237,5339,5554,317
PSCO,"1/9/2023 10 a.m. MST",5062,5188,5305,243
PSCO,"1/9/2023 11 a.m. MST",4970,5096,5151,181
PSCO,"1/9/2023 12 p.m. MST",4958,4953,5146,188
PSCO,"1/9/2023 1 p.m. MST",5066,4873,5305,239
PSCO,"1/9/2023 2 p.m. MST",5147,4807,5369,222
PSCO,"1/9/2023 3 p.m. MST",5119,4820,5363,244
PSCO,"1/9/2023 4 p.m. MST",5014,4973,5271,257
PSCO,"1/9/2023 5 p.m. MST",5265,5249,5598,333
PSCO,"1/9/2023 6 p.m. MST",5693,5656,5949,256
PSCO,"1/9/2023 7 p.m. MST",5667,5696,5902,235
PSCO,"1/9/2023 8 p.m. MST",5522,5561,5792,270
PSCO,"1/9/2023 9 p.m. MST",5391,5409,5571,180
PSCO,"1/9/2023 10 p.m. MST",5151,5211,5313,162
PSCO,"1/9/2023 11 p.m. MST",4798,4916,4949,151
PSCO,"1/10/2023 12 a.m. MST",4592,4681,4689,97
PSCO,"1/10/2023 1 a.m. MST",4447,4420,4628,181
PSCO,"1/10/2023 2 a.m. MST",4395,4322,4615,220
PSCO,"1/10/2023 3 a.m. MST",4350,4345,4632,282
PSCO,"1/10/2023 4 a.m. MST",4383,4383,4601,218
PSCO,"1/10/2023 5 a.m. MST",4500,4529,4736,236
PSCO,"1/10/2023 6 a.m. MST",4795,4773,5070,275
PSCO,"1/10/2023 7 a.m. MST",5205,5180,5420,215
PSCO,"1/10/2023 8 a.m. MST",5357,5345,5562,205
PSCO,"1/10/2023 9 a.m. MST",5196,5306,5446,250
PSCO,"1/10/2023 10 a.m. MST",5027,5056,5335,308
PSCO,"1/10/2023 11 a.m. MST",4870,4897,5160,290
PSCO,"1/10/2023 12 p.m. MST",4819,4772,5127,308
PSCO,"1/10/2023 1 p.m. MST",4744,4716,5032,288
PSCO,"1/10/2023 2 p.m. MST",4720,4655,5075,355
PSCO,"1/10/2023 3 p.m. MST",4720,4652,5090,370
PSCO,"1/10/2023 4 p.m. MST",4855,4788,5188,333
PSCO,"1/10/2023 5 p.m. MST",5166,5072,5482,316
PSCO,"1/10/2023 6 p.m. MST",5505,5445,5867,362
PSCO,"1/10/2023 7 p.m. MST",5470,5458,5691,221
PSCO,"1/10/2023 8 p.m. MST",5323,5368,5538,215
PSCO,"1/10/2023 9 p.m. MST",5157,5153,5431,274
PSCO,"1/10/2023 10 p.m. MST",4929,4927,5215,286
PSCO,"1/10/2023 11 p.m. MST",4629,4666,4960,331
PSCO,"1/11/2023 12 a.m. MST",4412,4468,4752,340
PSCO,"1/11/2023 1 a.m. MST",4287,4289,4536,249
PSCO,"1/11/2023 2 a.m. MST",4207,4255,4403,196
PSCO,"1/11/2023 3 a.m. MST",4215,4269,4399,184
PSCO,"1/11/2023 4 a.m. MST",4241,4307,4493,252
PSCO,"1/11/2023 5 a.m. MST",4335,4454,4509,174
PSCO,"1/11/2023 6 a.m. MST",4588,4683,4742,154
PSCO,"1/11/2023 7 a.m. MST",5070,5138,5152,82
PSCO,"1/11/2023 8 a.m. MST",5279,5355,5568,289
PSCO,"1/11/2023 9 a.m. MST",5468,5342,5662,194
PSCO,"1/11/2023 10 a.m. MST",5602,5269,5714,112
PSCO,"1/11/2023 11 a.m. MST",5715,5171,5898,183
PSCO,"1/11/2023 12 p.m. MST",5706,5105,5985,279
PSCO,"1/11/2023 1 p.m. MST",5608,5123,6078,470
PSCO,"1/11/2023 2 p.m. MST",5538,5141,5982,444
PSCO,"1/11/2023 3 p.m. MST",5531,5162,5883,352
PSCO,"1/11/2023 4 p.m. MST",5595,5275,5908,313
PSCO,"1/11/2023 5 p.m. MST",5817,5489,6044,227
PSCO,"1/11/2023 6 p.m. MST",6048,5726,6329,281
PSCO,"1/11/2023 7 p.m. MST",5940,5693,6290,350
PSCO,"1/11/2023 8 p.m. MST",5774,5548,6098,324
PSCO,"1/11/2023 9 p.m. MST",5613,5359,5985,372
PSCO,"1/11/2023 10 p.m. MST",5332,5136,5689,357
PSCO,"1/11/2023 11 p.m. MST",5022,4863,5302,280
PSCO,"1/12/2023 12 a.m. MST",4781,4644,5041,260
PSCO,"1/12/2023 1 a.m. MST",4616,4500,4886,270
PSCO,"1/12/2023 2 a.m. MST",4531,4409,4813,282
PSCO,"1/12/2023 3 a.m. MST",4481,4396,4891,410
PSCO,"1/12/2023 4 a.m. MST",4484,4484,4848,364
PSCO,"1/12/2023 5 a.m. MST",4590,4569,4786,196
PSCO,"1/12/2023 6 a.m. MST",4874,4860,5174,300
PSCO,"1/12/2023 7 a.m. MST",5370,5263,5647,277
PSCO,"1/12/2023 8 a.m. MST",5654,5443,5878,224
PSCO,"1/12/2023 9 a.m. MST",5512,5369,5790,278
PSCO,"1/12/2023 10 a.m. MST",5244,5208,5558,314
PSCO,"1/12/2023 11 a.m. MST",5046,5045,5279,233
PSCO,"1/12/2023 12 p.m. MST",4925,4886,5225,300
PSCO,"1/12/2023 1 p.m. MST",4817,4811,5187,370
PSCO,"1/12/2023 2 p.m. MST",4792,4746,5141,349
PSCO,"1/12/2023 3 p.m. MST",4807,4753,5015,208
PSCO,"1/12/2023 4 p.m. MST",4945,4887,5072,127
PSCO,"1/12/2023 5 p.m. MST",5238,5154,5392,154
PSCO,"1/12/2023 6 p.m. MST",5629,5582,5772,143
PSCO,"1/12/2023 7 p.m. MST",5627,5605,5940,313
PSCO,"1/12/2023 8 p.m. MST",5537,5508,5869,332
PSCO,"1/12/2023 9 p.m. MST",5464,5365,5755,291
PSCO,"1/12/2023 10 p.m. MST",5250,5170,5644,394
PSCO,"1/12/2023 11 p.m. MST",5002,4899,5302,300
PSCO,"1/13/2023 12 a.m. MST",4770,4657,5094,324
PSCO,"1/13/2023 1 a.m. MST",4604,4538,4873,269
PSCO,"1/13/2023 2 a.m. MST",4505,4445,4676,171
PSCO,"1/13/2023 3 a.m. MST",4464,4394,4664,200
PSCO,"1/13/2023 4 a.m. MST",4465,4453,4657,192
PSCO,"1/13/2023 5 a.m. MST",4596,4588,4805,209
PSCO,"1/13/2023 6 a.m. MST",4844,4853,5109,265
PSCO,"1/13/2023 7 a.m. MST",5216,5242,5429,213
PSCO,"1/13/2023 8 a.m. MST",5394,5398,5652,258
PSCO,"1/13/2023 9 a.m. MST",5292,5346,5561,269
PSCO,"1/13/2023 10 a.m. MST",5096,5094,5306,210
PSCO,"1/13/2023 11 a.m. MST",4855,4921,5112,257
PSCO,"1/13/2023 12 p.m. MST",4749,4819,5000,251
PSCO,"1/13/2023 1 p.m. MST",4654,4739,4901,247
PSCO,"1/13/2023 2 p.m. MST",4605,4664,4811,206
PSCO,"1/13/2023 3 p.m. MST",4603,4628,4825,222
PSCO,"1/13/2023 4 p.m. MST",4779,4798,4934,155
PSCO,"1/13/2023 5 p.m. MST",5067,5004,5194,127
PSCO,"1/13/2023 6 p.m. MST",5442,5368,5521,79
PSCO,"1/13/2023 7 p.m. MST",5424,5355,5539,115
PSCO,"1/13/2023 8 p.m. MST",5327,5243,5409,82
PSCO,"1/13/2023 9 p.m. MST",5231,5101,5287,56
PSCO,"1/13/2023 10 p.m. MST",5054,4933,5205,151
PSCO,"1/13/2023 11 p.m. MST",4804,4723,4911,107
PSCO,"1/14/2023 12 a.m. MST",4547,4544,4647,100
PSCO,"1/14/2023 1 a.m. MST",4360,4350,4606,246
PSCO,"1/14/2023 2 a.m. MST",4286,4316,4503,217
PSCO,"1/14/2023 3 a.m. MST",4223,4281,4395,172
PSCO,"1/14/2023 4 a.m. MST",4210,4265,4386,176
PSCO,"1/14/2023 5 a.m. MST",4260,4317,4407,147
PSCO,"1/14/2023 6 a.m. MST",4406,4399,4560,154
PSCO,"1/14/2023 7 a.m. MST",4616,4616,4664,48
PSCO,"1/14/2023 8 a.m. MST",4701,4737,4735,34
PSCO,"1/14/2023 9 a.m. MST",4717,4748,4693,-24
PSCO,"1/14/2023 10 a.m. MST",4604,4594,4663,59
PSCO,"1/14/2023 11 a.m. MST",4462,4530,4469,7
PSCO,"1/14/2023 12 p.m. MST",4340,4453,4404,64
PSCO,"1/14/2023 1 p.m. MST",4327,4430,4437,110
PSCO,"1/14/2023 2 p.m. MST",4326,4417,4367,41
PSCO,"1/14/2023 3 p.m. MST",4390,4433,4410,20
PSCO,"1/14/2023 4 p.m. MST",4508,4497,4530,22
PSCO,"1/14/2023 5 p.m. MST",4724,4734,4761,37
PSCO,"1/14/2023 6 p.m. MST",5048,5202,5127,79
PSCO,"1/14/2023 7 p.m. MST",5048,5166,5166,118
PSCO,"1/14/2023 8 p.m. MST",4966,5045,5031,65
PSCO,"1/14/2023 9 p.m. MST",4856,4950,4882,26
PSCO,"1/14/2023 10 p.m. MST",4704,4892,4964,260
PSCO,"1/14/2023 11 p.m. MST",4461,4701,4815,354
PSCO,"1/15/2023 12 a.m. MST",4310,4528,4740,430
PSCO,"1/15/2023 1 a.m. MST",4157,4319,4594,437
PSCO,"1/15/2023 2 a.m. MST",4093,4280,4442,349
PSCO,"1/15/2023 3 a.m. MST",4053,4191,4337,284
PSCO,"1/15/2023 4 a.m. MST",4027,4137,4292,265
PSCO,"1/15/2023 5 a.m. MST",4093,4186,4335,242
PSCO,"1/15/2023 6 a.m. MST",4226,4276,4529,303
PSCO,"1/15/2023 7 a.m. MST",4377,4447,4621,244
PSCO,"1/15/2023 8 a.m. MST",4465,4619,4703,238
PSCO,"1/15/2023 9 a.m. MST",4535,4721,4729,194
PSCO,"1/15/2023 10 a.m. MST",4630,4623,4843,213
PSCO,"1/15/2023 11 a.m. MST",4638,4607,4958,320
PSCO,"1/15/2023 12 p.m. MST",4591,4598,4879,288
PSCO,"1/15/2023 1 p.m. MST",4570,4563,4723,153
PSCO,"1/15/2023 2 p.m. MST",4642,4579,4796,154
PSCO,"1/15/2023 3 p.m. MST",4724,4585,4925,201
PSCO,"1/15/2023 4 p.m. MST",4849,4694,5034,185
PSCO,"1/15/2023 5 p.m. MST",5104,4967,5320,216
PSCO,"1/15/2023 6 p.m. MST",5387,5302,5557,170
PSCO,"1/15/2023 7 p.m. MST",5365,5257,5570,205
PSCO,"1/15/2023 8 p.m. MST",5258,5060,5372,114
PSCO,"1/15/2023 9 p.m. MST",5092,4989,5270,178
PSCO,"1/15/2023 10 p.m. MST",4896,4822,4981,85
PSCO,"1/15/2023 11 p.m. MST",4645,4608,4770,125
PSCO,"1/16/2023 12 a.m. MST",4488,4465,4616,128
PSCO,"1/16/2023 1 a.m. MST",4327,4412,4403,76
PSCO,"1/16/2023 2 a.m. MST",4267,4301,4365,98
PSCO,"1/16/2023 3 a.m. MST",4222,4263,4441,219
PSCO,"1/16/2023 4 a.m. MST",4290,4235,4511,221
PSCO,"1/16/2023 5 a.m. MST",4414,4388,4655,241
PSCO,"1/16/2023 6 a.m. MST",4647,4673,4954,307
PSCO,"1/16/2023 7 a.m. MST",4938,5001,5173,235
PSCO,"1/16/2023 8 a.m. MST",5029,5173,5272,243
PSCO,"1/16/2023 9 a.m. MST",5060,5138,5240,180
PSCO,"1/16/2023 10 a.m. MST",5064,5038,5192,128
PSCO,"1/16/2023 11 a.m. MST",5019,4957,5214,195
PSCO,"1/16/2023 12 p.m. MST",4941,4967,5318,377
PSCO,"1/16/2023 1 p.m. MST",4806,4920,5244,438
PSCO,"1/16/2023 2 p.m. MST",4725,4937,5018,293
PSCO,"1/16/2023 3 p.m. MST",4765,4981,5105,340
PSCO,"1/16/2023 4 p.m. MST",4859,5041,5294,435
PSCO,"1/16/2023 5 p.m. MST",5169,5412,5545,376
PSCO,"1/16/2023 6 p.m. MST",5600,5686,6021,421
PSCO,"1/16/2023 7 p.m. MST",5569,5668,6006,437
PSCO,"1/16/2023 8 p.m. MST",5440,5360,5779,339
PSCO,"1/16/2023 9 p.m. MST",5298,5338,5655,357
PSCO,"1/16/2023 10 p.m. MST",5077,5053,5428,351
PSCO,"1/16/2023 11 p.m. MST",4795,4800,5193,398
PSCO,"1/17/2023 12 a.m. MST",4561,4614,4862,301
PSCO,"1/17/2023 1 a.m. MST",4449,4501,4818,369
PSCO,"1/17/2023 2 a.m. MST",4372,4415,4798,426
PSCO,"1/17/2023 3 a.m. MST",4353,4385,4766,413
PSCO,"1/17/2023 4 a.m. MST",4397,4426,4773,376
PSCO,"1/17/2023 5 a.m. MST",4543,4552,4894,351
PSCO,"1/17/2023 6 a.m. MST",4808,4819,5109,301
PSCO,"1/17/2023 7 a.m. MST",5234,5263,5546,312
PSCO,"1/17/2023 8 a.m. MST",5413,5460,5885,472
PSCO,"1/17/2023 9 a.m. MST",5292,5367,5852,560
PSCO,"1/17/2023 10 a.m. MST",5044,5324,5604,560
PSCO,"1/17/2023 11 a.m. MST",5105,5171,5609,504
PSCO,"1/17/2023 12 p.m. MST",5014,5078,5556,542
PSCO,"1/17/2023 1 p.m. MST",4991,5038,5514,523
PSCO,"1/17/2023 2 p.m. MST",5191,5069,5574,383
PSCO,"1/17/2023 3 p.m. MST",5281,5001,5707,426
PSCO,"1/17/2023 4 p.m. MST",5390,5089,5780,390
PSCO,"1/17/2023 5 p.m. MST",5625,5338,5986,361
PSCO,"1/17/2023 6 p.m. MST",5930,5665,6439,509
PSCO,"1/17/2023 7 p.m. MST",5879,5626,6501,622
PSCO,"1/17/2023 8 p.m. MST",5685,5497,6358,673
PSCO,"1/17/2023 9 p.m. MST",5509,5331,6088,579
PSCO,"1/17/2023 10 p.m. MST",5268,5084,5838,570
PSCO,"1/17/2023 11 p.m. MST",4984,4815,5607,623
PSCO,"1/18/2023 12 a.m. MST",4776,4575,5343,567
PSCO,"1/18/2023 1 a.m. MST",4648,4448,5206,558
PSCO,"1/18/2023 2 a.m. MST",4524,4372,5169,645
PSCO,"1/18/2023 3 a.m. MST",4481,4408,5206,725
PSCO,"1/18/2023 4 a.m. MST",4539,4501,5256,717
PSCO,"1/18/2023 5 a.m. MST",4664,4655,5208,544
PSCO,"1/18/2023 6 a.m. MST",4838,4892,5518,680
PSCO,"1/18/2023 7 a.m. MST",5200,5265,5798,598
PSCO,"1/18/2023 8 a.m. MST",5386,5559,5981,595
PSCO,"1/18/2023 9 a.m. MST",5510,5630,6109,599
PSCO,"1/18/2023 10 a.m. MST",5641,5734,6266,625
PSCO,"1/18/2023 11 a.m. MST",5696,5714,6237,541
PSCO,"1/18/2023 12 p.m. MST",5754,5715,6264,510
PSCO,"1/18/2023 1 p.m. MST",5756,5672,6301,545
PSCO,"1/18/2023 2 p.m. MST",5739,5639,6261,522
PSCO,"1/18/2023 3 p.m. MST",5669,5598,6158,489
PSCO,"1/18/2023 4 p.m. MST",5703,5630,6131,428
PSCO,"1/18/2023 5 p.m. MST",5780,5837,6145,365
PSCO,"1/18/2023 6 p.m. MST",6039,5951,6481,442
PSCO,"1/18/2023 7 p.m. MST",5984,5849,6425,441
PSCO,"1/18/2023 8 p.m. MST",5830,5780,6317,487
PSCO,"1/18/2023 9 p.m. MST",5669,5581,6232,563
PSCO,"1/18/2023 10 p.m. MST",5402,5317,6032,630
PSCO,"1/18/2023 11 p.m. MST",5117,5071,5809,692
PSCO,"1/19/2023 12 a.m. MST",4933,4919,5568,635
PSCO,"1/19/2023 1 a.m. MST",4803,4842,5316,513
PSCO,"1/19/2023 2 a.m. MST",4730,4757,5334,604
PSCO,"1/19/2023 3 a.m. MST",4683,4696,5238,555
PSCO,"1/19/2023 4 a.m. MST",4744,4753,5260,516
PSCO,"1/19/2023 5 a.m. MST",4867,4842,5370,503
PSCO,"1/19/2023 6 a.m. MST",5125,5091,5572,447
PSCO,"1/19/2023 7 a.m. MST",5521,5442,6078,557
PSCO,"1/19/2023 8 a.m. MST",5685,5655,6223,538
PSCO,"1/19/2023 9 a.m. MST",5502,5560,6029,527
PSCO,"1/19/2023 10 a.m. MST",5551,5420,6078,527
PSCO,"1/19/2023 11 a.m. MST",5367,5295,5883,516
PSCO,"1/19/2023 12 p.m. MST",5354,5123,5937,583
PSCO,"1/19/2023 1 p.m. MST",5214,5014,5742,528
PSCO,"1/19/2023 2 p.m. MST",5234,5024,5709,475
PSCO,"1/19/2023 3 p.m. MST",5195,5081,5593,398
PSCO,"1/19/2023 4 p.m. MST",5235,5217,5611,376
PSCO,"1/19/2023 5 p.m. MST",5459,5523,6006,547
PSCO,"1/19/2023 6 p.m. MST",5833,5722,6377,544
PSCO,"1/19/2023 7 p.m. MST",5815,5743,6404,589
PSCO,"1/19/2023 8 p.m. MST",5725,5648,6316,591
PSCO,"1/19/2023 9 p.m. MST",5620,5491,6204,584
PSCO,"1/19/2023 10 p.m. MST",5358,5283,5947,589
PSCO,"1/19/2023 11 p.m. MST",5059,5020,5729,670
PSCO,"1/20/2023 12 a.m. MST",4885,4880,5880,995
PSCO,"1/20/2023 1 a.m. MST",4661,4667,5601,940
PSCO,"1/20/2023 2 a.m. MST",4554,4587,5591,1037
PSCO,"1/20/2023 3 a.m. MST",4535,4627,5574,1039
PSCO,"1/20/2023 4 a.m. MST",4552,4646,5554,1002
PSCO,"1/20/2023 5 a.m. MST",4684,4755,5655,971
PSCO,"1/20/2023 6 a.m. MST",4944,4997,6011,1067
PSCO,"1/20/2023 7 a.m. MST",5314,5365,6148,834
PSCO,"1/20/2023 8 a.m. MST",5574,5557,6344,770
PSCO,"1/20/2023 9 a.m. MST",5573,5583,6284,711
PSCO,"1/20/2023 10 a.m. MST",5496,5610,6105,609
PSCO,"1/20/2023 11 a.m. MST",5464,5565,5939,475
PSCO,"1/20/2023 12 p.m. MST",5433,5560,6008,575
PSCO,"1/20/2023 1 p.m. MST",5352,5534,5813,461
PSCO,"1/20/2023 2 p.m. MST",5346,5512,5783,437
PSCO,"1/20/2023 3 p.m. MST",5349,5456,5781,432
PSCO,"1/20/2023 4 p.m. MST",5409,5486,5854,445
PSCO,"1/20/2023 5 p.m. MST",5573,5652,6082,509
PSCO,"1/20/2023 6 p.m. MST",5875,5814,6342,467
PSCO,"1/20/2023 7 p.m. MST",5789,5725,6305,516
PSCO,"1/20/2023 8 p.m. MST",5668,5552,6146,478
PSCO,"1/20/2023 9 p.m. MST",5553,5385,6088,535
PSCO,"1/20/2023 10 p.m. MST",5389,5196,6011,622
PSCO,"1/20/2023 11 p.m. MST",5182,4987,6052,870
PSCO,"1/21/2023 12 a.m. MST",4944,4811,5893,949
PSCO,"1/21/2023 1 a.m. MST",4805,4688,5767,962
PSCO,"1/21/2023 2 a.m. MST",4723,4604,5653,930
PSCO,"1/21/2023 3 a.m. MST",4693,4611,5664,971
PSCO,"1/21/2023 4 a.m. MST",4667,4552,5684,1017
PSCO,"1/21/2023 5 a.m. MST",4712,4638,5557,845
PSCO,"1/21/2023 6 a.m. MST",4758,4785,5518,760
PSCO,"1/21/2023 7 a.m. MST",4982,4958,5726,744
PSCO,"1/21/2023 8 a.m. MST",5152,5138,5782,630
PSCO,"1/21/2023 9 a.m. MST",5253,5121,5875,622
PSCO,"1/21/2023 10 a.m. MST",5299,5116,5775,476
PSCO,"1/21/2023 11 a.m. MST",5239,5035,5629,390
PSCO,"1/21/2023 12 p.m. MST",5200,5011,5498,298
PSCO,"1/21/2023 1 p.m. MST",5190,5030,5485,295
PSCO,"1/21/2023 2 p.m. MST",5196,4878,5459,263
PSCO,"1/21/2023 3 p.m. MST",5196,4896,5507,311
PSCO,"1/21/2023 4 p.m. MST",5253,5041,5495,242
PSCO,"1/21/2023 5 p.m. MST",5418,5288,5740,322
PSCO,"1/21/2023 6 p.m. MST",5758,5656,6082,324
PSCO,"1/21/2023 7 p.m. MST",5765,5606,6219,454
PSCO,"1/21/2023 8 p.m. MST",5590,5482,6092,502
PSCO,"1/21/2023 9 p.m. MST",5472,5403,5910,438
PSCO,"1/21/2023 10 p.m. MST",5277,5321,5722,445
PSCO,"1/21/2023 11 p.m. MST",4996,5139,5493,497
PSCO,"1/22/2023 12 a.m. MST",4741,4762,5240,499
PSCO,"1/22/2023 1 a.m. MST",4616,4720,5097,481
PSCO,"1/22/2023 2 a.m. MST",4526,4691,4965,439
PSCO,"1/22/2023 3 a.m. MST",4457,4651,4919,462
PSCO,"1/22/2023 4 a.m. MST",4447,4559,4943,496
PSCO,"1/22/2023 5 a.m. MST",4496,4643,5037,541
PSCO,"1/22/2023 6 a.m. MST",4671,4727,5083,412
PSCO,"1/22/2023 7 a.m. MST",4839,4886,5241,402
PSCO,"1/22/2023 8 a.m. MST",4960,5011,5387,427
PSCO,"1/22/2023 9 a.m. MST",4980,4994,5466,486
PSCO,"1/22/2023 10 a.m. MST",4892,4921,5335,443
PSCO,"1/22/2023 11 a.m. MST",4796,4867,5191,395
PSCO,"1/22/2023 12 p.m. MST",4770,4620,5143,373
PSCO,"1/22/2023 1 p.m. MST",4724,4516,5138,414
PSCO,"1/22/2023 2 p.m. MST",4714,4575,5114,400
PSCO,"1/22/2023 3 p.m. MST",4723,4671,5077,354
PSCO,"1/22/2023 4 p.m. MST",4812,4781,5110,298
PSCO,"1/22/2023 5 p.m. MST",5163,5209,5701,538
PSCO,"1/22/2023 6 p.m. MST",5576,5429,6216,640
PSCO,"1/22/2023 7 p.m. MST",5656,5557,6318,662
PSCO,"1/22/2023 8 p.m. MST",5533,5387,6230,697
PSCO,"1/22/2023 9 p.m. MST",5400,5298,6099,699
PSCO,"1/22/2023 10 p.m. MST",5152,5094,5867,715
PSCO,"1/22/2023 11 p.m. MST",4893,4842,5610,717
PSCO,"1/23/2023 12 a.m. MST",4640,4791,5230,590
PSCO,"1/23/2023 1 a.m. MST",4523,4661,5127,604
PSCO,"1/23/2023 2 a.m. MST",4431,4702,5051,620
PSCO,"1/23/2023 3 a.m. MST",4384,4677,5059,675
PSCO,"1/23/2023 4 a.m. MST",4445,4806,5162,717
PSCO,"1/23/2023 5 a.m. MST",4577,4897,5329,752
PSCO,"1/23/2023 6 a.m. MST",4838,5046,5458,620
PSCO,"1/23/2023 7 a.m. MST",5226,5416,5769,543
PSCO,"1/23/2023 8 a.m. MST",5528,5647,6104,576
PSCO,"1/23/2023 9 a.m. MST",5586,5728,6223,637
PSCO,"1/23/2023 10 a.m. MST",5516,5797,6161,645
PSCO,"1/23/2023 11 a.m. MST",5373,5802,5893,520
PSCO,"1/23/2023 12 p.m. MST",5248,5822,5746,498
PSCO,"1/23/2023 1 p.m. MST",5126,5799,5559,433
PSCO,"1/23/2023 2 p.m. MST",5119,5771,5448,329
PSCO,"1/23/2023 3 p.m. MST",5095,5724,5494,399
PSCO,"1/23/2023 4 p.m. MST",5162,5740,5601,439
PSCO,"1/23/2023 5 p.m. MST",5463,5890,5800,337
PSCO,"1/23/2023 6 p.m. MST",5910,5978,6380,470
PSCO,"1/23/2023 7 p.m. MST",5927,5981,6445,518
PSCO,"1/23/2023 8 p.m. MST",5826,5892,6326,500
PSCO,"1/23/2023 9 p.m. MST",5632,5726,6264,632
PSCO,"1/23/2023 10 p.m. MST",5377,5483,6024,647
PSCO,"1/23/2023 11 p.m. MST",5053,5203,5674,621
PSCO,"1/24/2023 12 a.m. MST",4822,4980,5489,667
PSCO,"1/24/2023 1 a.m. MST",4690,4827,5286,596
PSCO,"1/24/2023 2 a.m. MST",4648,4780,5328,680
PSCO,"1/24/2023 3 a.m. MST",4584,4796,5206,622
PSCO,"1/24/2023 4 a.m. MST",4590,4887,5216,626
PSCO,"1/24/2023 5 a.m. MST",4763,4996,5340,577
PSCO,"1/24/2023 6 a.m. MST",5025,5211,5688,663
PSCO,"1/24/2023 7 a.m. MST",5468,5584,6006,538
PSCO,"1/24/2023 8 a.m. MST",5697,5735,6444,747
PSCO,"1/24/2023 9 a.m. MST",5635,5666,6358,723
PSCO,"1/24/2023 10 a.m. MST",5496,5479,6191,695
PSCO,"1/24/2023 11 a.m. MST",5404,5382,5907,503
PSCO,"1/24/2023 12 p.m. MST",5191,5321,5738,547
PSCO,"1/24/2023 1 p.m. MST",5132,5281,5635,503
PSCO,"1/24/2023 2 p.m. MST",5122,5227,5595,473
PSCO,"1/24/2023 3 p.m. MST",5137,5216,5661,524
PSCO,"1/24/2023 4 p.m. MST",5248,5320,5742,494
PSCO,"1/24/2023 5 p.m. MST",5509,5483,5991,482
PSCO,"1/24/2023 6 p.m. MST",5956,5820,6377,421
PSCO,"1/24/2023 7 p.m. MST",5932,5915,6182,250
PSCO,"1/24/2023 8 p.m. MST",5841,5798,6034,193
PSCO,"1/24/2023 9 p.m. MST",5722,5639,5918,196
PSCO,"1/24/2023 10 p.m. MST",5477,5389,5669,192
PSCO,"1/24/2023 11 p.m. MST",5147,5132,5467,320
PSCO,"1/25/2023 12 a.m. MST",4912,4905,5286,374
PSCO,"1/25/2023 1 a.m. MST",4841,4658,5103,262
PSCO,"1/25/2023 2 a.m. MST",4752,4603,5084,332
PSCO,"1/25/2023 3 a.m. MST",4729,4594,5033,304
PSCO,"1/25/2023 4 a.m. MST",4732,4653,5165,433
PSCO,"1/25/2023 5 a.m. MST",4839,4764,5300,461
PSCO,"1/25/2023 6 a.m. MST",5088,5014,5473,385
PSCO,"1/25/2023 7 a.m. MST",5492,5395,5917,425
PSCO,"1/25/2023 8 a.m. MST",5761,5625,6093,332
PSCO,"1/25/2023 9 a.m. MST",5786,5601,5965,179
PSCO,"1/25/2023 10 a.m. MST",5764,5572,6115,351
PSCO,"1/25/2023 11 a.m. MST",5686,5516,6076,390
PSCO,"1/25/2023 12 p.m. MST",5535,5436,5888,353
PSCO,"1/25/2023 1 p.m. MST",5365,5368,5798,433
PSCO,"1/25/2023 2 p.m. MST",5393,5347,5744,351
PSCO,"1/25/2023 3 p.m. MST",5415,5316,5734,319
PSCO,"1/25/2023 4 p.m. MST",5511,5363,5852,341
PSCO,"1/25/2023 5 p.m. MST",5704,5573,6088,384
PSCO,"1/25/2023 6 p.m. MST",6066,5816,6461,395
PSCO,"1/25/2023 7 p.m. MST",6114,5828,6489,375
PSCO,"1/25/2023 8 p.m. MST",5954,5739,6363,409
PSCO,"1/25/2023 9 p.m. MST",5843,5554,6181,338
PSCO,"1/25/2023 10 p.m. MST",5570,5328,5945,375
PSCO,"1/25/2023 11 p.m. MST",5277,5043,5692,415
PSCO,"1/26/2023 12 a.m. MST",5031,4861,5298,267
PSCO,"1/26/2023 1 a.m. MST",4897,4736,5303,406
PSCO,"1/26/2023 2 a.m. MST",4839,4676,5278,439
PSCO,"1/26/2023 3 a.m. MST",4823,4652,5284,461
PSCO,"1/26/2023 4 a.m. MST",4811,4705,5319,508
PSCO,"1/26/2023 5 a.m. MST",4980,4826,5477,497
PSCO,"1/26/2023 6 a.m. MST",5251,5090,5723,472
PSCO,"1/26/2023 7 a.m. MST",5675,5453,6062,387
PSCO,"1/26/2023 8 a.m. MST",5882,5652,6277,395
PSCO,"1/26/2023 9 a.m. MST",5771,5574,6008,237
PSCO,"1/26/2023 10 a.m. MST",5573,5380,5839,266
PSCO,"1/26/2023 11 a.m. MST",5379,5235,5719,340
PSCO,"1/26/2023 12 p.m. MST",5248,5075,5663,415
PSCO,"1/26/2023 1 p.m. MST",5142,5007,5356,214
PSCO,"1/26/2023 2 p.m. MST",5097,4972,5183,86
PSCO,"1/26/2023 3 p.m. MST",5160,4913,5305,145
PSCO,"1/26/2023 4 p.m. MST",5289,5096,5417,128
PSCO,"1/26/2023 5 p.m. MST",5602,5344,5857,255
PSCO,"1/26/2023 6 p.m. MST",5942,5643,6148,206
PSCO,"1/26/2023 7 p.m. MST",5949,5694,6107,158
PSCO,"1/26/2023 8 p.m. MST",5839,5611,5957,118
PSCO,"1/26/2023 9 p.m. MST",5681,5453,5787,106
PSCO,"1/26/2023 10 p.m. MST",5421,5266,5563,142
PSCO,"1/26/2023 11 p.m. MST",5098,4949,5256,158
PSCO,"1/27/2023 12 a.m. MST",4841,4737,5024,183
PSCO,"1/27/2023 1 a.m. MST",4676,4606,4869,193
PSCO,"1/27/2023 2 a.m. MST",4579,4521,4724,145
PSCO,"1/27/2023 3 a.m. MST",4552,4509,4644,92
PSCO,"1/27/2023 4 a.m. MST",4575,4545,4658,83
PSCO,"1/27/2023 5 a.m. MST",4688,4647,4722,34
PSCO,"1/27/2023 6 a.m. MST",4934,4909,5061,127
PSCO,"1/27/2023 7 a.m. MST",5335,5299,5446,111
PSCO,"1/27/2023 8 a.m. MST",5535,5490,5695,160
PSCO,"1/27/2023 9 a.m. MST",5495,5426,5567,72
PSCO,"1/27/2023 10 a.m. MST",5289,5308,5476,187
PSCO,"1/27/2023 11 a.m. MST",5223,5200,5481,258
PSCO,"1/27/2023 12 p.m. MST",5154,5137,5550,396
PSCO,"1/27/2023 1 p.m. MST",5052,5117,5393,341
PSCO,"1/27/2023 2 p.m. MST",4983,5102,5265,282
PSCO,"1/27/2023 3 p.m. MST",4989,5100,5188,199
PSCO,"1/27/2023 4 p.m. MST",5065,5150,5267,202
PSCO,"1/27/2023 5 p.m. MST",5230,5308,5422,192
PSCO,"1/27/2023 6 p.m. MST",5609,5462,5723,114
PSCO,"1/27/2023 7 p.m. MST",5671,5445,5758,87
PSCO,"1/27/2023 8 p.m. MST",5572,5332,5528,-44
PSCO,"1/27/2023 9 p.m. MST",5407,5234,5665,258
PSCO,"1/27/2023 10 p.m. MST",5234,5099,5563,329
PSCO,"1/27/2023 11 p.m. MST",4985,4908,5380,395
PSCO,"1/28/2023 12 a.m. MST",4767,4705,5218,451
PSCO,"1/28/2023 1 a.m. MST",4579,4509,5018,439
PSCO,"1/28/2023 2 a.m. MST",4480,4377,4828,348
PSCO,"1/28/2023 3 a.m. MST",4424,4386,4742,318
PSCO,"1/28/2023 4 a.m. MST",4446,4433,4811,365
PSCO,"1/28/2023 5 a.m. MST",4505,4449,5077,572
PSCO,"1/28/2023 6 a.m. MST",4643,4601,5115,472
PSCO,"1/28/2023 7 a.m. MST",4849,4778,5158,309
PSCO,"1/28/2023 8 a.m. MST",5016,4958,5185,169
PSCO,"1/28/2023 9 a.m. MST",5000,5038,5085,85
PSCO,"1/28/2023 10 a.m. MST",4981,4969,4999,18
PSCO,"1/28/2023 11 a.m. MST",4977,4938,4960,-17
PSCO,"1/28/2023 12 p.m. MST",4992,5095,4900,-92
PSCO,"1/28/2023 1 p.m. MST",4965,5103,4884,-81
PSCO,"1/28/2023 2 p.m. MST",4977,5112,4925,-52
PSCO,"1/28/2023 3 p.m. MST",5066,5161,5036,-30
PSCO,"1/28/2023 4 p.m. MST",5174,5183,5094,-80
PSCO,"1/28/2023 5 p.m. MST",5399,5380,5273,-126
PSCO,"1/28/2023 6 p.m. MST",5723,5567,5664,-59
PSCO,"1/28/2023 7 p.m. MST",5800,5563,5875,75
PSCO,"1/28/2023 8 p.m. MST",5708,5442,5855,147
PSCO,"1/28/2023 9 p.m. MST",5617,5371,5866,249
PSCO,"1/28/2023 10 p.m. MST",5481,5308,5740,259
PSCO,"1/28/2023 11 p.m. MST",5278,5106,5542,264
PSCO,"1/29/2023 12 a.m. MST",5083,4856,5411,328
PSCO,"1/29/2023 1 a.m. MST",4918,4693,5393,475
PSCO,"1/29/2023 2 a.m. MST",4855,4638,5350,495
PSCO,"1/29/2023 3 a.m. MST",4804,4549,5318,514
PSCO,"1/29/2023 4 a.m. MST",4856,4596,5386,530
PSCO,"1/29/2023 5 a.m. MST",4963,4644,5499,536
PSCO,"1/29/2023 6 a.m. MST",4974,4694,5466,492
PSCO,"1/29/2023 7 a.m. MST",5162,4829,5536,374
PSCO,"1/29/2023 8 a.m. MST",5342,4976,5668,326
PSCO,"1/29/2023 9 a.m. MST",5512,5088,5672,160
PSCO,"1/29/2023 10 a.m. MST",5646,5105,5650,4
PSCO,"1/29/2023 11 a.m. MST",5761,5177,5755,-6
PSCO,"1/29/2023 12 p.m. MST",5767,5252,5722,-45
PSCO,"1/29/2023 1 p.m. MST",5803,5250,5732,-71
PSCO,"1/29/2023 2 p.m. MST",5888,5277,5820,-68
PSCO,"1/29/2023 3 p.m. MST",5883,5239,5811,-72
PSCO,"1/29/2023 4 p.m. MST",5983,5312,5957,-26
PSCO,"1/29/2023 5 p.m. MST",6158,5525,6139,-19
PSCO,"1/29/2023 6 p.m. MST",6434,5906,6418,-16
PSCO,"1/29/2023 7 p.m. MST",6716,5951,6797,81
PSCO,"1/29/2023 8 p.m. MST",6130,5808,6216,86
PSCO,"1/29/2023 9 p.m. MST",6189,5696,6217,28
PSCO,"1/29/2023 10 p.m. MST",5800,5472,5851,51
PSCO,"1/29/2023 11 p.m. MST",5650,5202,5811,161
PSCO,"1/30/2023 12 a.m. MST",5411,5090,5590,179
PSCO,"1/30/2023 1 a.m. MST",5281,5006,5421,140
PSCO,"1/30/2023 2 a.m. MST",5244,4940,5459,215
PSCO,"1/30/2023 3 a.m. MST",5220,4896,5415,195
PSCO,"1/30/2023 4 a.m. MST",5188,4954,5394,206
PSCO,"1/30/2023 5 a.m. MST",5298,5104,5442,144
PSCO,"1/30/2023 6 a.m. MST",5472,5442,5319,-153
PSCO,"1/30/2023 7 a.m. MST",5918,5734,5447,-471
PSCO,"1/30/2023 8 a.m. MST",6172,6000,5693,-479
PSCO,"1/30/2023 9 a.m. MST",6193,6086,5637,-556
PSCO,"1/30/2023 10 a.m. MST",6158,6089,5830,-328
PSCO,"1/30/2023 11 a.m. MST",6161,6089,5914,-247
PSCO,"1/30/2023 12 p.m. MST",6108,6091,5721,-387
PSCO,"1/30/2023 1 p.m. MST",6108,6064,5832,-276
PSCO,"1/30/2023 2 p.m. MST",6013,6042,5794,-219
PSCO,"1/30/2023 3 p.m. MST",5976,6012,5812,-164
PSCO,"1/30/2023 4 p.m. MST",6039,6044,5819,-220
PSCO,"1/30/2023 5 p.m. MST",6242,6180,5682,-560
PSCO,"1/30/2023 6 p.m. MST",6541,6366,5775,-766
PSCO,"1/30/2023 7 p.m. MST",6645,6363,5930,-715
PSCO,"1/30/2023 8 p.m. MST",6539,6202,5869,-670
PSCO,"1/30/2023 9 p.m. MST",6358,6065,5681,-677
PSCO,"1/30/2023 10 p.m. MST",5994,5834,5559,-435
PSCO,"1/30/2023 11 p.m. MST",5729,5506,5709,-20
PSCO,"1/31/2023 12 a.m. MST",5481,5196,5637,156
PSCO,"1/31/2023 1 a.m. MST",5332,5056,5458,126
PSCO,"1/31/2023 2 a.m. MST",5201,4981,5346,145
PSCO,"1/31/2023 3 a.m. MST",5178,5018,5335,157
PSCO,"1/31/2023 4 a.m. MST",5263,5068,5372,109
PSCO,"1/31/2023 5 a.m. MST",5374,5224,5467,93
PSCO,"1/31/2023 6 a.m. MST",5604,5387,5701,97
PSCO,"1/31/2023 7 a.m. MST",5992,5770,6127,135
PSCO,"1/31/2023 8 a.m. MST",6212,5993,6414,202
PSCO,"1/31/2023 9 a.m. MST",6177,5899,6281,104
PSCO,"1/31/2023 10 a.m. MST",6083,5766,6158,75
PSCO,"1/31/2023 11 a.m. MST",5943,5593,6221,278
PSCO,"1/31/2023 12 p.m. MST",5773,5387,6078,305
PSCO,"1/31/2023 1 p.m. MST",5548,5304,6097,549
PSCO,"1/31/2023 2 p.m. MST",5422,5243,5972,550
PSCO,"1/31/2023 3 p.m. MST",5353,5234,5935,582
PSCO,"1/31/2023 4 p.m. MST",5359,5305,5919,560
PSCO,"1/31/2023 5 p.m. MST",5628,5488,6122,494
PSCO,"1/31/2023 6 p.m. MST",6109,5867,6504,395
PSCO,"1/31/2023 7 p.m. MST",6243,6065,6562,319
PSCO,"1/31/2023 8 p.m. MST",6166,5968,6496,330
PSCO,"1/31/2023 9 p.m. MST",6040,5811,6461,421
PSCO,"1/31/2023 10 p.m. MST",5817,5582,6263,446
PSCO,"1/31/2023 11 p.m. MST",5488,5289,6069,581
PSCO,"2/1/2023 12 a.m. MST",5253,5055,5797,544
