"BA Code","Timestamp (Hour Ending)","Demand (MWh)","Demand Forecast (MWh)","Net Generation (MWh)","Total Interchange (MWh)"
PSCO,"5/1/2023 12 a.m. MDT",3825,4028,3929,104
PSCO,"5/1/2023 1 a.m. MDT",3686,3803,4274,588
PSCO,"5/1/2023 2 a.m. MDT",3579,3691,4143,564
PSCO,"5/1/2023 3 a.m. MDT",3680,3664,4130,450
PSCO,"5/1/2023 4 a.m. MDT",3792,3690,4235,443
PSCO,"5/1/2023 5 a.m. MDT",3858,3760,4258,400
PSCO,"5/1/2023 6 a.m. MDT",4029,3993,4168,139
PSCO,"5/1/2023 7 a.m. MDT",4164,4243,4143,-21
PSCO,"5/1/2023 8 a.m. MDT",4224,4356,4254,30
PSCO,"5/1/2023 9 a.m. MDT",4152,4308,4241,89
PSCO,"5/1/2023 10 a.m. MDT",4079,4262,4112,33
PSCO,"5/1/2023 11 a.m. MDT",4026,4218,3888,-138
PSCO,"5/1/2023 12 p.m. MDT",4021,4217,3860,-161
PSCO,"5/1/2023 1 p.m. MDT",4078,4260,3955,-123
PSCO,"5/1/2023 2 p.m. MDT",4132,4278,3958,-174
PSCO,"5/1/2023 3 p.m. MDT",4224,4374,3907,-317
PSCO,"5/1/2023 4 p.m. MDT",4367,4490,3965,-402
PSCO,"5/1/2023 5 p.m. MDT",4558,4611,4251,-307
PSCO,"5/1/2023 6 p.m. MDT",4773,4684,4576,-197
PSCO,"5/1/2023 7 p.m. MDT",4842,4818,4771,-71
PSCO,"5/1/2023 8 p.m. MDT",4843,4788,4896,53
PSCO,"5/1/2023 9 p.m. MDT",4893,4834,5212,319
PSCO,"5/1/2023 10 p.m. MDT",4662,4749,5090,428
PSCO,"5/1/2023 11 p.m. MDT",4325,4415,4696,371
PSCO,"5/2/2023 12 a.m. MDT",4022,4077,4354,332
PSCO,"5/2/2023 1 a.m. MDT",3794,3867,4081,287
PSCO,"5/2/2023 2 a.m. MDT",3672,3737,4124,452
PSCO,"5/2/2023 3 a.m. MDT",3582,3679,4076,494
PSCO,"5/2/2023 4 a.m. MDT",3581,3705,3878,297
PSCO,"5/2/2023 5 a.m. MDT",3666,3790,3901,235
PSCO,"5/2/2023 6 a.m. MDT",3853,3987,4033,180
PSCO,"5/2/2023 7 a.m. MDT",4104,4238,4152,48
PSCO,"5/2/2023 8 a.m. MDT",4176,4350,4235,59
PSCO,"5/2/2023 9 a.m. MDT",4198,4319,4589,391
PSCO,"5/2/2023 10 a.m. MDT",4157,4284,4564,407
PSCO,"5/2/2023 11 a.m. MDT",4219,4259,4598,379
PSCO,"5/2/2023 12 p.m. MDT",4247,4256,4694,447
PSCO,"5/2/2023 1 p.m. MDT",4308,4376,4867,559
PSCO,"5/2/2023 2 p.m. MDT",4383,4490,4914,531
PSCO,"5/2/2023 3 p.m. MDT",4558,4649,5193,635
PSCO,"5/2/2023 4 p.m. MDT",4792,4709,5386,594
PSCO,"5/2/2023 5 p.m. MDT",4913,4773,5422,509
PSCO,"5/2/2023 6 p.m. MDT",4975,4823,5444,469
PSCO,"5/2/2023 7 p.m. MDT",4985,4837,5442,457
PSCO,"5/2/2023 8 p.m. MDT",4771,4743,5026,255
PSCO,"5/2/2023 9 p.m. MDT",4808,4854,5048,240
PSCO,"5/2/2023 10 p.m. MDT",4629,4702,5111,482
PSCO,"5/2/2023 11 p.m. MDT",4305,4404,4762,457
PSCO,"5/3/2023 12 a.m. MDT",4024,4058,4447,423
PSCO,"5/3/2023 1 a.m. MDT",3831,3854,4203,372
PSCO,"5/3/2023 2 a.m. MDT",3717,3719,4205,488
PSCO,"5/3/2023 3 a.m. MDT",3656,3675,4147,491
PSCO,"5/3/2023 4 a.m. MDT",3635,3631,4141,506
PSCO,"5/3/2023 5 a.m. MDT",3724,3725,4282,558
PSCO,"5/3/2023 6 a.m. MDT",3967,3936,4549,582
PSCO,"5/3/2023 7 a.m. MDT",4245,4230,4649,404
PSCO,"5/3/2023 8 a.m. MDT",4326,4394,4583,257
PSCO,"5/3/2023 9 a.m. MDT",4330,4471,4589,259
PSCO,"5/3/2023 10 a.m. MDT",4301,4449,4578,277
PSCO,"5/3/2023 11 a.m. MDT",4344,4411,4526,182
PSCO,"5/3/2023 12 p.m. MDT",4400,4456,4515,115
PSCO,"5/3/2023 1 p.m. MDT",4299,4493,4430,131
PSCO,"5/3/2023 2 p.m. MDT",4328,4548,4366,38
PSCO,"5/3/2023 3 p.m. MDT",4439,4630,4431,-8
PSCO,"5/3/2023 4 p.m. MDT",4617,4741,4515,-102
PSCO,"5/3/2023 5 p.m. MDT",4814,4880,4752,-62
PSCO,"5/3/2023 6 p.m. MDT",4981,4975,4910,-71
PSCO,"5/3/2023 7 p.m. MDT",5075,5048,4917,-158
PSCO,"5/3/2023 8 p.m. MDT",5025,5050,4683,-342
PSCO,"5/3/2023 9 p.m. MDT",5050,4963,4824,-226
PSCO,"5/3/2023 10 p.m. MDT",4800,4835,4681,-119
PSCO,"5/3/2023 11 p.m. MDT",4437,4436,4384,-53
PSCO,"5/4/2023 12 a.m. MDT",4337,4077,4245,-92
PSCO,"5/4/2023 1 a.m. MDT",4067,3763,3888,-179
PSCO,"5/4/2023 2 a.m. MDT",3905,3671,3794,-111
PSCO,"5/4/2023 3 a.m. MDT",3827,3545,3664,-163
PSCO,"5/4/2023 4 a.m. MDT",3754,3491,3472,-282
PSCO,"5/4/2023 5 a.m. MDT",3691,3580,3404,-287
PSCO,"5/4/2023 6 a.m. MDT",3908,3772,3695,-213
PSCO,"5/4/2023 7 a.m. MDT",4207,4144,4118,-89
PSCO,"5/4/2023 8 a.m. MDT",4448,4346,4337,-111
PSCO,"5/4/2023 9 a.m. MDT",4567,4418,4373,-194
PSCO,"5/4/2023 10 a.m. MDT",4562,4419,4317,-245
PSCO,"5/4/2023 11 a.m. MDT",4561,4394,4396,-165
PSCO,"5/4/2023 12 p.m. MDT",4487,4446,4333,-154
PSCO,"5/4/2023 1 p.m. MDT",4466,4566,4326,-140
PSCO,"5/4/2023 2 p.m. MDT",4484,4564,4435,-49
PSCO,"5/4/2023 3 p.m. MDT",4365,4635,4238,-127
PSCO,"5/4/2023 4 p.m. MDT",4615,4647,4519,-96
PSCO,"5/4/2023 5 p.m. MDT",4712,4696,4914,202
PSCO,"5/4/2023 6 p.m. MDT",4640,4687,4926,286
PSCO,"5/4/2023 7 p.m. MDT",4645,4641,4800,155
PSCO,"5/4/2023 8 p.m. MDT",4685,4607,4689,4
PSCO,"5/4/2023 9 p.m. MDT",4771,4586,4653,-118
PSCO,"5/4/2023 10 p.m. MDT",4608,4466,4461,-147
PSCO,"5/4/2023 11 p.m. MDT",4296,4215,4018,-278
PSCO,"5/5/2023 12 a.m. MDT",3985,3937,3566,-419
PSCO,"5/5/2023 1 a.m. MDT",3794,3711,3624,-170
PSCO,"5/5/2023 2 a.m. MDT",3671,3636,3283,-388
PSCO,"5/5/2023 3 a.m. MDT",3597,3529,3151,-446
PSCO,"5/5/2023 4 a.m. MDT",3620,3531,3238,-382
PSCO,"5/5/2023 5 a.m. MDT",3695,3604,3495,-200
PSCO,"5/5/2023 6 a.m. MDT",3905,3768,3729,-176
PSCO,"5/5/2023 7 a.m. MDT",4119,4030,3924,-195
PSCO,"5/5/2023 8 a.m. MDT",4216,4146,4014,-202
PSCO,"5/5/2023 9 a.m. MDT",4154,4153,3984,-170
PSCO,"5/5/2023 10 a.m. MDT",4103,4195,3729,-374
PSCO,"5/5/2023 11 a.m. MDT",4136,4160,3777,-359
PSCO,"5/5/2023 12 p.m. MDT",4192,4189,3949,-243
PSCO,"5/5/2023 1 p.m. MDT",4331,4263,4120,-211
PSCO,"5/5/2023 2 p.m. MDT",4643,4320,4331,-312
PSCO,"5/5/2023 3 p.m. MDT",4923,4361,4777,-146
PSCO,"5/5/2023 4 p.m. MDT",4912,4631,5007,95
PSCO,"5/5/2023 5 p.m. MDT",4864,4624,4992,128
PSCO,"5/5/2023 6 p.m. MDT",4835,4577,5126,291
PSCO,"5/5/2023 7 p.m. MDT",4879,4511,5087,208
PSCO,"5/5/2023 8 p.m. MDT",4878,4448,5023,145
PSCO,"5/5/2023 9 p.m. MDT",4746,4506,4917,171
PSCO,"5/5/2023 10 p.m. MDT",4519,4366,4426,-93
PSCO,"5/5/2023 11 p.m. MDT",4289,4110,4393,104
PSCO,"5/6/2023 12 a.m. MDT",3970,3913,4098,128
PSCO,"5/6/2023 1 a.m. MDT",3712,3795,3937,225
PSCO,"5/6/2023 2 a.m. MDT",3584,3614,3812,228
PSCO,"5/6/2023 3 a.m. MDT",3510,3612,3349,-161
PSCO,"5/6/2023 4 a.m. MDT",3486,3564,3270,-216
PSCO,"5/6/2023 5 a.m. MDT",3580,3573,3328,-252
PSCO,"5/6/2023 6 a.m. MDT",3680,3590,3377,-303
PSCO,"5/6/2023 7 a.m. MDT",3761,3591,3446,-315
PSCO,"5/6/2023 8 a.m. MDT",3787,3592,3712,-75
PSCO,"5/6/2023 9 a.m. MDT",3785,3640,3873,88
PSCO,"5/6/2023 10 a.m. MDT",3686,3670,3980,294
PSCO,"5/6/2023 11 a.m. MDT",3679,3699,3977,298
PSCO,"5/6/2023 12 p.m. MDT",3676,3748,3838,162
PSCO,"5/6/2023 1 p.m. MDT",3681,3838,3706,25
PSCO,"5/6/2023 2 p.m. MDT",3711,3872,3745,34
PSCO,"5/6/2023 3 p.m. MDT",3907,3993,3844,-63
PSCO,"5/6/2023 4 p.m. MDT",4125,4121,4251,126
PSCO,"5/6/2023 5 p.m. MDT",4331,4207,4696,365
PSCO,"5/6/2023 6 p.m. MDT",4394,4383,4820,426
PSCO,"5/6/2023 7 p.m. MDT",4434,4524,4919,485
PSCO,"5/6/2023 8 p.m. MDT",4443,4608,4788,345
PSCO,"5/6/2023 9 p.m. MDT",4498,4538,4900,402
PSCO,"5/6/2023 10 p.m. MDT",4394,4420,4639,245
PSCO,"5/6/2023 11 p.m. MDT",4132,4206,4495,363
PSCO,"5/7/2023 12 a.m. MDT",3889,3938,4433,544
PSCO,"5/7/2023 1 a.m. MDT",3708,3732,4157,449
PSCO,"5/7/2023 2 a.m. MDT",3564,3621,3982,418
PSCO,"5/7/2023 3 a.m. MDT",3458,3526,4007,549
PSCO,"5/7/2023 4 a.m. MDT",3454,3508,4051,597
PSCO,"5/7/2023 5 a.m. MDT",3447,3513,3965,518
PSCO,"5/7/2023 6 a.m. MDT",3555,3517,3811,256
PSCO,"5/7/2023 7 a.m. MDT",3592,3524,3589,-3
PSCO,"5/7/2023 8 a.m. MDT",3611,3536,3586,-25
PSCO,"5/7/2023 9 a.m. MDT",3640,3546,3734,94
PSCO,"5/7/2023 10 a.m. MDT",3663,3546,3743,80
PSCO,"5/7/2023 11 a.m. MDT",3745,3538,3774,29
PSCO,"5/7/2023 12 p.m. MDT",3862,3603,3740,-122
PSCO,"5/7/2023 1 p.m. MDT",3861,3651,3871,10
PSCO,"5/7/2023 2 p.m. MDT",3876,3645,3840,-36
PSCO,"5/7/2023 3 p.m. MDT",3917,3784,3925,8
PSCO,"5/7/2023 4 p.m. MDT",4070,3902,4082,12
PSCO,"5/7/2023 5 p.m. MDT",4212,4074,4081,-131
PSCO,"5/7/2023 6 p.m. MDT",4412,4244,4567,155
PSCO,"5/7/2023 7 p.m. MDT",4477,4532,4643,166
PSCO,"5/7/2023 8 p.m. MDT",4552,4508,4760,208
PSCO,"5/7/2023 9 p.m. MDT",4633,4456,4680,47
PSCO,"5/7/2023 10 p.m. MDT",4496,4291,4568,72
PSCO,"5/7/2023 11 p.m. MDT",4155,4081,4172,17
PSCO,"5/8/2023 12 a.m. MDT",3870,3801,3779,-91
PSCO,"5/8/2023 1 a.m. MDT",3672,3695,3676,4
PSCO,"5/8/2023 2 a.m. MDT",3496,3593,3401,-95
PSCO,"5/8/2023 3 a.m. MDT",3459,3528,3404,-55
PSCO,"5/8/2023 4 a.m. MDT",3472,3537,3396,-76
PSCO,"5/8/2023 5 a.m. MDT",3584,3629,3540,-44
PSCO,"5/8/2023 6 a.m. MDT",3810,3845,3650,-160
PSCO,"5/8/2023 7 a.m. MDT",4076,4090,4027,-49
PSCO,"5/8/2023 8 a.m. MDT",4174,4214,4340,166
PSCO,"5/8/2023 9 a.m. MDT",4164,4194,4312,148
PSCO,"5/8/2023 10 a.m. MDT",4116,4194,4285,169
PSCO,"5/8/2023 11 a.m. MDT",4173,4182,4374,201
PSCO,"5/8/2023 12 p.m. MDT",4291,4177,4524,233
PSCO,"5/8/2023 1 p.m. MDT",4423,4261,4590,167
PSCO,"5/8/2023 2 p.m. MDT",4518,4347,4678,160
PSCO,"5/8/2023 3 p.m. MDT",4513,4420,4790,277
PSCO,"5/8/2023 4 p.m. MDT",4594,4583,4963,369
PSCO,"5/8/2023 5 p.m. MDT",4745,4818,5180,435
PSCO,"5/8/2023 6 p.m. MDT",4845,4901,5343,498
PSCO,"5/8/2023 7 p.m. MDT",4826,4912,5191,365
PSCO,"5/8/2023 8 p.m. MDT",4827,4839,5128,301
PSCO,"5/8/2023 9 p.m. MDT",4850,4909,5034,184
PSCO,"5/8/2023 10 p.m. MDT",4703,4727,5152,449
PSCO,"5/8/2023 11 p.m. MDT",4463,4344,4983,520
PSCO,"5/9/2023 12 a.m. MDT",4158,3993,4893,735
PSCO,"5/9/2023 1 a.m. MDT",3976,3798,4637,661
PSCO,"5/9/2023 2 a.m. MDT",3799,3680,4492,693
PSCO,"5/9/2023 3 a.m. MDT",3759,3583,4507,748
PSCO,"5/9/2023 4 a.m. MDT",3618,3561,4316,698
PSCO,"5/9/2023 5 a.m. MDT",3685,3626,4315,630
PSCO,"5/9/2023 6 a.m. MDT",3920,3824,4440,520
PSCO,"5/9/2023 7 a.m. MDT",4203,4083,4229,26
PSCO,"5/9/2023 8 a.m. MDT",4276,4223,4253,-23
PSCO,"5/9/2023 9 a.m. MDT",4220,4235,4228,8
PSCO,"5/9/2023 10 a.m. MDT",4195,4243,4057,-138
PSCO,"5/9/2023 11 a.m. MDT",4197,4200,4060,-137
PSCO,"5/9/2023 12 p.m. MDT",4248,4246,4152,-96
PSCO,"5/9/2023 1 p.m. MDT",4258,4378,4255,-3
PSCO,"5/9/2023 2 p.m. MDT",4361,4492,4597,236
PSCO,"5/9/2023 3 p.m. MDT",4556,4564,4911,355
PSCO,"5/9/2023 4 p.m. MDT",4741,4765,5192,451
PSCO,"5/9/2023 5 p.m. MDT",4952,4923,5478,526
PSCO,"5/9/2023 6 p.m. MDT",5104,5067,5653,549
PSCO,"5/9/2023 7 p.m. MDT",5111,5130,5524,413
PSCO,"5/9/2023 8 p.m. MDT",5126,5074,5606,480
PSCO,"5/9/2023 9 p.m. MDT",5092,5086,5567,475
PSCO,"5/9/2023 10 p.m. MDT",4877,4821,5420,543
PSCO,"5/9/2023 11 p.m. MDT",4525,4491,5284,759
PSCO,"5/10/2023 12 a.m. MDT",4200,4119,4812,612
PSCO,"5/10/2023 1 a.m. MDT",3942,3858,4394,452
PSCO,"5/10/2023 2 a.m. MDT",3712,3696,4204,492
PSCO,"5/10/2023 3 a.m. MDT",3662,3600,4175,513
PSCO,"5/10/2023 4 a.m. MDT",3646,3564,3996,350
PSCO,"5/10/2023 5 a.m. MDT",3693,3629,3863,170
PSCO,"5/10/2023 6 a.m. MDT",3875,3796,3902,27
PSCO,"5/10/2023 7 a.m. MDT",4149,4099,4198,49
PSCO,"5/10/2023 8 a.m. MDT",4404,4347,4520,116
PSCO,"5/10/2023 9 a.m. MDT",4518,4367,4997,479
PSCO,"5/10/2023 10 a.m. MDT",4550,4425,4870,320
PSCO,"5/10/2023 11 a.m. MDT",4570,4478,4788,218
PSCO,"5/10/2023 12 p.m. MDT",4548,4557,4710,162
PSCO,"5/10/2023 1 p.m. MDT",4574,4696,4575,1
PSCO,"5/10/2023 2 p.m. MDT",4581,4833,4557,-24
PSCO,"5/10/2023 3 p.m. MDT",4602,4808,4713,111
PSCO,"5/10/2023 4 p.m. MDT",4745,4811,5016,271
PSCO,"5/10/2023 5 p.m. MDT",4838,4821,5124,286
PSCO,"5/10/2023 6 p.m. MDT",4899,4815,4988,89
PSCO,"5/10/2023 7 p.m. MDT",4802,4771,5186,384
PSCO,"5/10/2023 8 p.m. MDT",4724,4751,4874,150
PSCO,"5/10/2023 9 p.m. MDT",4660,4812,4811,151
PSCO,"5/10/2023 10 p.m. MDT",4512,4673,4740,228
PSCO,"5/10/2023 11 p.m. MDT",4286,4345,4567,281
PSCO,"5/11/2023 12 a.m. MDT",4180,4048,4430,250
PSCO,"5/11/2023 1 a.m. MDT",4025,3810,4214,189
PSCO,"5/11/2023 2 a.m. MDT",3886,3668,4173,287
PSCO,"5/11/2023 3 a.m. MDT",3868,3591,4247,379
PSCO,"5/11/2023 4 a.m. MDT",3871,3567,3870,-1
PSCO,"5/11/2023 5 a.m. MDT",3944,3640,3875,-69
PSCO,"5/11/2023 6 a.m. MDT",4139,3857,4142,3
PSCO,"5/11/2023 7 a.m. MDT",4481,4166,4520,39
PSCO,"5/11/2023 8 a.m. MDT",4678,4409,4636,-42
PSCO,"5/11/2023 9 a.m. MDT",4698,4467,4614,-84
PSCO,"5/11/2023 10 a.m. MDT",4787,4466,5014,227
PSCO,"5/11/2023 11 a.m. MDT",4870,4453,5164,294
PSCO,"5/11/2023 12 p.m. MDT",4859,4478,5020,161
PSCO,"5/11/2023 1 p.m. MDT",4831,4463,5044,213
PSCO,"5/11/2023 2 p.m. MDT",4843,4480,4933,90
PSCO,"5/11/2023 3 p.m. MDT",4794,4492,5017,223
PSCO,"5/11/2023 4 p.m. MDT",4761,4456,5085,324
PSCO,"5/11/2023 5 p.m. MDT",4839,4558,5006,167
PSCO,"5/11/2023 6 p.m. MDT",4899,4641,5271,372
PSCO,"5/11/2023 7 p.m. MDT",4932,4639,5194,262
PSCO,"5/11/2023 8 p.m. MDT",4927,4570,4960,33
PSCO,"5/11/2023 9 p.m. MDT",4892,4667,4887,-5
PSCO,"5/11/2023 10 p.m. MDT",4742,4536,4767,25
PSCO,"5/11/2023 11 p.m. MDT",4439,4263,4456,17
PSCO,"5/12/2023 12 a.m. MDT",4158,3985,4405,247
PSCO,"5/12/2023 1 a.m. MDT",3964,3799,4167,203
PSCO,"5/12/2023 2 a.m. MDT",3832,3640,4032,200
PSCO,"5/12/2023 3 a.m. MDT",3816,3543,4195,379
PSCO,"5/12/2023 4 a.m. MDT",3822,3561,4489,667
PSCO,"5/12/2023 5 a.m. MDT",3907,3660,4551,644
PSCO,"5/12/2023 6 a.m. MDT",4097,3883,4851,754
PSCO,"5/12/2023 7 a.m. MDT",4399,4174,5178,779
PSCO,"5/12/2023 8 a.m. MDT",4567,4418,5350,783
PSCO,"5/12/2023 9 a.m. MDT",4606,4543,5489,883
PSCO,"5/12/2023 10 a.m. MDT",4616,4589,5279,663
PSCO,"5/12/2023 11 a.m. MDT",4493,4583,5151,658
PSCO,"5/12/2023 12 p.m. MDT",4362,4577,5047,685
PSCO,"5/12/2023 1 p.m. MDT",4352,4591,4977,625
PSCO,"5/12/2023 2 p.m. MDT",4362,4553,4878,516
PSCO,"5/12/2023 3 p.m. MDT",4370,4517,4753,383
PSCO,"5/12/2023 4 p.m. MDT",4333,4482,4909,576
PSCO,"5/12/2023 5 p.m. MDT",4375,4535,4924,549
PSCO,"5/12/2023 6 p.m. MDT",4454,4628,5019,565
PSCO,"5/12/2023 7 p.m. MDT",4489,4642,5175,686
PSCO,"5/12/2023 8 p.m. MDT",4537,4630,5459,922
PSCO,"5/12/2023 9 p.m. MDT",4634,4463,5554,920
PSCO,"5/12/2023 10 p.m. MDT",4518,4402,5406,888
PSCO,"5/12/2023 11 p.m. MDT",4259,4171,5023,764
PSCO,"5/13/2023 12 a.m. MDT",4023,3919,4664,641
PSCO,"5/13/2023 1 a.m. MDT",3820,3826,4390,570
PSCO,"5/13/2023 2 a.m. MDT",3734,3698,4154,420
PSCO,"5/13/2023 3 a.m. MDT",3676,3638,4111,435
PSCO,"5/13/2023 4 a.m. MDT",3658,3572,4128,470
PSCO,"5/13/2023 5 a.m. MDT",3669,3573,4167,498
PSCO,"5/13/2023 6 a.m. MDT",3747,3668,4293,546
PSCO,"5/13/2023 7 a.m. MDT",3793,3698,4365,572
PSCO,"5/13/2023 8 a.m. MDT",3833,3805,4290,457
PSCO,"5/13/2023 9 a.m. MDT",3826,3926,4227,401
PSCO,"5/13/2023 10 a.m. MDT",3767,3955,4183,416
PSCO,"5/13/2023 11 a.m. MDT",3835,3993,4286,451
PSCO,"5/13/2023 12 p.m. MDT",3897,3946,4404,507
PSCO,"5/13/2023 1 p.m. MDT",3925,3815,4403,478
PSCO,"5/13/2023 2 p.m. MDT",4013,3848,4573,560
PSCO,"5/13/2023 3 p.m. MDT",4096,3911,4702,606
PSCO,"5/13/2023 4 p.m. MDT",4149,3995,5025,876
PSCO,"5/13/2023 5 p.m. MDT",4289,4033,5003,714
PSCO,"5/13/2023 6 p.m. MDT",4337,4213,4951,614
PSCO,"5/13/2023 7 p.m. MDT",4387,4351,4628,241
PSCO,"5/13/2023 8 p.m. MDT",4429,4412,4564,135
PSCO,"5/13/2023 9 p.m. MDT",4479,4460,4792,313
PSCO,"5/13/2023 10 p.m. MDT",4347,4335,4749,402
PSCO,"5/13/2023 11 p.m. MDT",4137,4101,4472,335
PSCO,"5/14/2023 12 a.m. MDT",3907,3897,4186,279
PSCO,"5/14/2023 1 a.m. MDT",3946,3787,3993,47
PSCO,"5/14/2023 2 a.m. MDT",3821,3684,3728,-93
PSCO,"5/14/2023 3 a.m. MDT",3752,3587,3749,-3
PSCO,"5/14/2023 4 a.m. MDT",3719,3531,3758,39
PSCO,"5/14/2023 5 a.m. MDT",3588,3553,3645,57
PSCO,"5/14/2023 6 a.m. MDT",3645,3583,3635,-10
PSCO,"5/14/2023 7 a.m. MDT",3716,3608,3757,41
PSCO,"5/14/2023 8 a.m. MDT",3832,3664,3898,66
PSCO,"5/14/2023 9 a.m. MDT",3869,3752,3924,55
PSCO,"5/14/2023 10 a.m. MDT",3922,3919,3968,46
PSCO,"5/14/2023 11 a.m. MDT",4015,3983,4178,163
PSCO,"5/14/2023 12 p.m. MDT",3999,3977,4133,134
PSCO,"5/14/2023 1 p.m. MDT",3940,3953,4052,112
PSCO,"5/14/2023 2 p.m. MDT",3874,3953,4123,249
PSCO,"5/14/2023 3 p.m. MDT",3917,3975,4310,393
PSCO,"5/14/2023 4 p.m. MDT",3994,4064,4361,367
PSCO,"5/14/2023 5 p.m. MDT",4113,4132,4407,294
PSCO,"5/14/2023 6 p.m. MDT",4273,4221,4597,324
PSCO,"5/14/2023 7 p.m. MDT",4371,4252,4772,401
PSCO,"5/14/2023 8 p.m. MDT",4456,4243,4983,527
PSCO,"5/14/2023 9 p.m. MDT",4564,4340,5057,493
PSCO,"5/14/2023 10 p.m. MDT",4441,4302,4936,495
PSCO,"5/14/2023 11 p.m. MDT",4151,4007,4672,521
PSCO,"5/15/2023 12 a.m. MDT",3870,3797,4288,418
PSCO,"5/15/2023 1 a.m. MDT",3702,3631,4012,310
PSCO,"5/15/2023 2 a.m. MDT",3603,3485,3838,235
PSCO,"5/15/2023 3 a.m. MDT",3513,3429,3919,406
PSCO,"5/15/2023 4 a.m. MDT",3533,3407,3975,442
PSCO,"5/15/2023 5 a.m. MDT",3682,3524,4132,450
PSCO,"5/15/2023 6 a.m. MDT",3902,3741,4296,394
PSCO,"5/15/2023 7 a.m. MDT",4194,4017,4244,50
PSCO,"5/15/2023 8 a.m. MDT",4375,4208,4364,-11
PSCO,"5/15/2023 9 a.m. MDT",4441,4268,4427,-14
PSCO,"5/15/2023 10 a.m. MDT",4510,4293,4418,-92
PSCO,"5/15/2023 11 a.m. MDT",4491,4292,4251,-240
PSCO,"5/15/2023 12 p.m. MDT",4497,4290,4419,-78
PSCO,"5/15/2023 1 p.m. MDT",4480,4337,4310,-170
PSCO,"5/15/2023 2 p.m. MDT",4464,4388,4257,-207
PSCO,"5/15/2023 3 p.m. MDT",4479,4440,4142,-337
PSCO,"5/15/2023 4 p.m. MDT",4483,4508,4146,-337
PSCO,"5/15/2023 5 p.m. MDT",4477,4562,4221,-256
PSCO,"5/15/2023 6 p.m. MDT",4533,4588,4217,-316
PSCO,"5/15/2023 7 p.m. MDT",4555,4616,4341,-214
PSCO,"5/15/2023 8 p.m. MDT",4575,4637,4323,-252
PSCO,"5/15/2023 9 p.m. MDT",4644,4693,4565,-79
PSCO,"5/15/2023 10 p.m. MDT",4506,4565,4705,199
PSCO,"5/15/2023 11 p.m. MDT",4211,4189,4290,79
PSCO,"5/16/2023 12 a.m. MDT",3926,3894,3821,-105
PSCO,"5/16/2023 1 a.m. MDT",3734,3705,3607,-127
PSCO,"5/16/2023 2 a.m. MDT",3682,3579,3616,-66
PSCO,"5/16/2023 3 a.m. MDT",3631,3489,3583,-48
PSCO,"5/16/2023 4 a.m. MDT",3660,3480,3629,-31
PSCO,"5/16/2023 5 a.m. MDT",3729,3556,3598,-131
PSCO,"5/16/2023 6 a.m. MDT",3945,3735,3759,-186
PSCO,"5/16/2023 7 a.m. MDT",4147,4003,4065,-82
PSCO,"5/16/2023 8 a.m. MDT",4218,4113,4424,206
PSCO,"5/16/2023 9 a.m. MDT",4185,4129,4338,153
PSCO,"5/16/2023 10 a.m. MDT",4243,4126,4287,44
PSCO,"5/16/2023 11 a.m. MDT",4350,4178,4831,481
PSCO,"5/16/2023 12 p.m. MDT",4411,4191,5045,634
PSCO,"5/16/2023 1 p.m. MDT",4583,4350,5231,648
PSCO,"5/16/2023 2 p.m. MDT",4711,4437,5411,700
PSCO,"5/16/2023 3 p.m. MDT",4743,4523,5254,511
PSCO,"5/16/2023 4 p.m. MDT",4628,4637,5214,586
PSCO,"5/16/2023 5 p.m. MDT",4825,4947,5343,518
PSCO,"5/16/2023 6 p.m. MDT",5006,4963,5389,383
PSCO,"5/16/2023 7 p.m. MDT",5025,4933,5296,271
PSCO,"5/16/2023 8 p.m. MDT",4965,4912,5066,101
PSCO,"5/16/2023 9 p.m. MDT",4899,4885,5099,200
PSCO,"5/16/2023 10 p.m. MDT",4690,4739,4948,258
PSCO,"5/16/2023 11 p.m. MDT",4388,4364,4625,237
PSCO,"5/17/2023 12 a.m. MDT",4047,3998,4094,47
PSCO,"5/17/2023 1 a.m. MDT",3883,3734,3809,-74
PSCO,"5/17/2023 2 a.m. MDT",3653,3604,3857,204
PSCO,"5/17/2023 3 a.m. MDT",3615,3484,3762,147
PSCO,"5/17/2023 4 a.m. MDT",3595,3472,3538,-57
PSCO,"5/17/2023 5 a.m. MDT",3674,3603,3676,2
PSCO,"5/17/2023 6 a.m. MDT",3879,3754,3903,24
PSCO,"5/17/2023 7 a.m. MDT",4115,4008,4018,-97
PSCO,"5/17/2023 8 a.m. MDT",4231,4149,4233,2
PSCO,"5/17/2023 9 a.m. MDT",4265,4181,4349,84
PSCO,"5/17/2023 10 a.m. MDT",4294,4169,4316,22
PSCO,"5/17/2023 11 a.m. MDT",4334,4208,4338,4
PSCO,"5/17/2023 12 p.m. MDT",4433,4246,4448,15
PSCO,"5/17/2023 1 p.m. MDT",4557,4389,4561,4
PSCO,"5/17/2023 2 p.m. MDT",4671,4474,4725,54
PSCO,"5/17/2023 3 p.m. MDT",4750,4534,4849,99
PSCO,"5/17/2023 4 p.m. MDT",4894,4724,5024,130
PSCO,"5/17/2023 5 p.m. MDT",4995,4872,5180,185
PSCO,"5/17/2023 6 p.m. MDT",5124,4899,5396,272
PSCO,"5/17/2023 7 p.m. MDT",5151,4971,5290,139
PSCO,"5/17/2023 8 p.m. MDT",5145,4869,5468,323
PSCO,"5/17/2023 9 p.m. MDT",5212,4914,5698,486
PSCO,"5/17/2023 10 p.m. MDT",5079,4733,5564,485
PSCO,"5/17/2023 11 p.m. MDT",4702,4363,4929,227
PSCO,"5/18/2023 12 a.m. MDT",4209,3984,4456,247
PSCO,"5/18/2023 1 a.m. MDT",3840,3782,4176,336
PSCO,"5/18/2023 2 a.m. MDT",3701,3577,3763,62
PSCO,"5/18/2023 3 a.m. MDT",3592,3484,3588,-4
PSCO,"5/18/2023 4 a.m. MDT",3533,3453,3645,112
PSCO,"5/18/2023 5 a.m. MDT",3647,3532,3659,12
PSCO,"5/18/2023 6 a.m. MDT",3823,3730,3851,28
PSCO,"5/18/2023 7 a.m. MDT",4069,4029,4045,-24
PSCO,"5/18/2023 8 a.m. MDT",4244,4263,4094,-150
PSCO,"5/18/2023 9 a.m. MDT",4361,4419,4276,-85
PSCO,"5/18/2023 10 a.m. MDT",4327,4410,4423,96
PSCO,"5/18/2023 11 a.m. MDT",4285,4410,4427,142
PSCO,"5/18/2023 12 p.m. MDT",4342,4418,4529,187
PSCO,"5/18/2023 1 p.m. MDT",4678,4416,4788,110
PSCO,"5/18/2023 2 p.m. MDT",4743,4449,4891,148
PSCO,"5/18/2023 3 p.m. MDT",4554,4494,4911,357
PSCO,"5/18/2023 4 p.m. MDT",4460,4534,4903,443
PSCO,"5/18/2023 5 p.m. MDT",4586,4573,4831,245
PSCO,"5/18/2023 6 p.m. MDT",4765,4621,4812,47
PSCO,"5/18/2023 7 p.m. MDT",4621,4565,4640,19
PSCO,"5/18/2023 8 p.m. MDT",4616,4540,4834,218
PSCO,"5/18/2023 9 p.m. MDT",4620,4560,4891,271
PSCO,"5/18/2023 10 p.m. MDT",4443,4455,4691,248
PSCO,"5/18/2023 11 p.m. MDT",4163,4152,4412,249
PSCO,"5/19/2023 12 a.m. MDT",3927,3876,4341,414
PSCO,"5/19/2023 1 a.m. MDT",3749,3704,4211,462
PSCO,"5/19/2023 2 a.m. MDT",3659,3556,4150,491
PSCO,"5/19/2023 3 a.m. MDT",3728,3473,4055,327
PSCO,"5/19/2023 4 a.m. MDT",3717,3429,4057,340
PSCO,"5/19/2023 5 a.m. MDT",3796,3532,4018,222
PSCO,"5/19/2023 6 a.m. MDT",3943,3704,3976,33
PSCO,"5/19/2023 7 a.m. MDT",4096,3994,4000,-96
PSCO,"5/19/2023 8 a.m. MDT",4359,4225,4180,-179
PSCO,"5/19/2023 9 a.m. MDT",4498,4332,4376,-122
PSCO,"5/19/2023 10 a.m. MDT",4629,4299,4504,-125
PSCO,"5/19/2023 11 a.m. MDT",4639,4243,4452,-187
PSCO,"5/19/2023 12 p.m. MDT",4626,4225,4433,-193
PSCO,"5/19/2023 1 p.m. MDT",4543,4235,4371,-172
PSCO,"5/19/2023 2 p.m. MDT",4438,4241,4288,-150
PSCO,"5/19/2023 3 p.m. MDT",4384,4282,4180,-204
PSCO,"5/19/2023 4 p.m. MDT",4405,4291,4195,-210
PSCO,"5/19/2023 5 p.m. MDT",4532,4364,4326,-206
PSCO,"5/19/2023 6 p.m. MDT",4550,4437,4383,-167
PSCO,"5/19/2023 7 p.m. MDT",4543,4428,4478,-65
PSCO,"5/19/2023 8 p.m. MDT",4477,4363,4511,34
PSCO,"5/19/2023 9 p.m. MDT",4512,4495,4592,80
PSCO,"5/19/2023 10 p.m. MDT",4380,4391,4580,200
PSCO,"5/19/2023 11 p.m. MDT",4148,4123,4228,80
PSCO,"5/20/2023 12 a.m. MDT",3872,3856,3986,114
PSCO,"5/20/2023 1 a.m. MDT",3729,3747,3957,228
PSCO,"5/20/2023 2 a.m. MDT",3626,3577,3832,206
PSCO,"5/20/2023 3 a.m. MDT",3543,3550,3800,257
PSCO,"5/20/2023 4 a.m. MDT",3498,3494,3662,164
PSCO,"5/20/2023 5 a.m. MDT",3550,3527,3649,99
PSCO,"5/20/2023 6 a.m. MDT",3627,3587,3827,200
PSCO,"5/20/2023 7 a.m. MDT",3721,3597,4123,402
PSCO,"5/20/2023 8 a.m. MDT",3741,3698,4009,268
PSCO,"5/20/2023 9 a.m. MDT",3900,3755,4000,100
PSCO,"5/20/2023 10 a.m. MDT",3928,3708,4073,145
PSCO,"5/20/2023 11 a.m. MDT",3897,3707,4222,325
PSCO,"5/20/2023 12 p.m. MDT",3911,3743,4270,359
PSCO,"5/20/2023 1 p.m. MDT",4003,3771,4287,284
PSCO,"5/20/2023 2 p.m. MDT",4005,3868,4333,328
PSCO,"5/20/2023 3 p.m. MDT",4028,3959,4165,137
PSCO,"5/20/2023 4 p.m. MDT",4086,4123,4064,-22
PSCO,"5/20/2023 5 p.m. MDT",4181,4183,4233,52
PSCO,"5/20/2023 6 p.m. MDT",4371,4305,4477,106
PSCO,"5/20/2023 7 p.m. MDT",4384,4343,4489,105
PSCO,"5/20/2023 8 p.m. MDT",4341,4395,4584,243
PSCO,"5/20/2023 9 p.m. MDT",4389,4371,4550,161
PSCO,"5/20/2023 10 p.m. MDT",4374,4301,4509,135
PSCO,"5/20/2023 11 p.m. MDT",4148,4033,4174,26
PSCO,"5/21/2023 12 a.m. MDT",3894,3828,3790,-104
PSCO,"5/21/2023 1 a.m. MDT",3670,3719,3488,-182
PSCO,"5/21/2023 2 a.m. MDT",3546,3608,3485,-61
PSCO,"5/21/2023 3 a.m. MDT",3442,3521,3273,-169
PSCO,"5/21/2023 4 a.m. MDT",3415,3485,3235,-180
PSCO,"5/21/2023 5 a.m. MDT",3434,3487,3336,-98
PSCO,"5/21/2023 6 a.m. MDT",3478,3514,3483,5
PSCO,"5/21/2023 7 a.m. MDT",3486,3506,3487,1
PSCO,"5/21/2023 8 a.m. MDT",3488,3563,3533,45
PSCO,"5/21/2023 9 a.m. MDT",3516,3629,3356,-160
PSCO,"5/21/2023 10 a.m. MDT",3555,3695,3451,-104
PSCO,"5/21/2023 11 a.m. MDT",3582,3760,3465,-117
PSCO,"5/21/2023 12 p.m. MDT",3655,3884,3506,-149
PSCO,"5/21/2023 1 p.m. MDT",3713,3890,3575,-138
PSCO,"5/21/2023 2 p.m. MDT",3816,3958,3759,-57
PSCO,"5/21/2023 3 p.m. MDT",3958,4003,3936,-22
PSCO,"5/21/2023 4 p.m. MDT",4126,4181,4120,-6
PSCO,"5/21/2023 5 p.m. MDT",4339,4410,4301,-38
PSCO,"5/21/2023 6 p.m. MDT",4581,4544,4503,-78
PSCO,"5/21/2023 7 p.m. MDT",4691,4807,4610,-81
PSCO,"5/21/2023 8 p.m. MDT",4698,4768,4465,-233
PSCO,"5/21/2023 9 p.m. MDT",4711,4721,4444,-267
PSCO,"5/21/2023 10 p.m. MDT",4584,4513,4417,-167
PSCO,"5/21/2023 11 p.m. MDT",4258,4188,3916,-342
PSCO,"5/22/2023 12 a.m. MDT",3898,3855,3529,-369
PSCO,"5/22/2023 1 a.m. MDT",3704,3678,3360,-344
PSCO,"5/22/2023 2 a.m. MDT",3541,3503,3221,-320
PSCO,"5/22/2023 3 a.m. MDT",3494,3415,3165,-329
PSCO,"5/22/2023 4 a.m. MDT",3482,3426,3257,-225
PSCO,"5/22/2023 5 a.m. MDT",3552,3483,3170,-382
PSCO,"5/22/2023 6 a.m. MDT",3707,3643,3345,-362
PSCO,"5/22/2023 7 a.m. MDT",4002,3886,3687,-315
PSCO,"5/22/2023 8 a.m. MDT",4124,4037,3870,-254
PSCO,"5/22/2023 9 a.m. MDT",4150,4134,3908,-242
PSCO,"5/22/2023 10 a.m. MDT",4194,4171,3917,-277
PSCO,"5/22/2023 11 a.m. MDT",4180,4206,3969,-211
PSCO,"5/22/2023 12 p.m. MDT",4196,4303,3916,-280
PSCO,"5/22/2023 1 p.m. MDT",4246,4481,3920,-326
PSCO,"5/22/2023 2 p.m. MDT",4360,4617,4170,-190
PSCO,"5/22/2023 3 p.m. MDT",4508,4731,4342,-166
PSCO,"5/22/2023 4 p.m. MDT",4708,4872,4535,-173
PSCO,"5/22/2023 5 p.m. MDT",4835,5026,4674,-161
PSCO,"5/22/2023 6 p.m. MDT",4922,5138,4744,-178
PSCO,"5/22/2023 7 p.m. MDT",4955,5103,4688,-267
PSCO,"5/22/2023 8 p.m. MDT",4887,5003,4737,-150
PSCO,"5/22/2023 9 p.m. MDT",4884,4959,4913,29
PSCO,"5/22/2023 10 p.m. MDT",4732,4809,4783,51
PSCO,"5/22/2023 11 p.m. MDT",4383,4384,4618,235
PSCO,"5/23/2023 12 a.m. MDT",4037,4048,4284,247
PSCO,"5/23/2023 1 a.m. MDT",3767,3814,3925,158
PSCO,"5/23/2023 2 a.m. MDT",3634,3619,3688,54
PSCO,"5/23/2023 3 a.m. MDT",3543,3525,3650,107
PSCO,"5/23/2023 4 a.m. MDT",3520,3496,3591,71
PSCO,"5/23/2023 5 a.m. MDT",3584,3557,3503,-81
PSCO,"5/23/2023 6 a.m. MDT",3784,3718,3807,23
PSCO,"5/23/2023 7 a.m. MDT",4029,3947,4168,139
PSCO,"5/23/2023 8 a.m. MDT",4146,4105,4302,156
PSCO,"5/23/2023 9 a.m. MDT",4149,4163,4187,38
PSCO,"5/23/2023 10 a.m. MDT",4160,4232,4236,76
PSCO,"5/23/2023 11 a.m. MDT",4195,4314,4294,99
PSCO,"5/23/2023 12 p.m. MDT",4276,4403,4318,42
PSCO,"5/23/2023 1 p.m. MDT",4391,4599,4484,93
PSCO,"5/23/2023 2 p.m. MDT",4534,4754,4763,229
PSCO,"5/23/2023 3 p.m. MDT",4707,4865,5018,311
PSCO,"5/23/2023 4 p.m. MDT",4908,5047,5146,238
PSCO,"5/23/2023 5 p.m. MDT",5162,5208,5368,206
PSCO,"5/23/2023 6 p.m. MDT",5282,5312,5628,346
PSCO,"5/23/2023 7 p.m. MDT",5230,5335,5567,337
PSCO,"5/23/2023 8 p.m. MDT",5178,5144,5484,306
PSCO,"5/23/2023 9 p.m. MDT",5152,5132,5550,398
PSCO,"5/23/2023 10 p.m. MDT",4963,4945,5235,272
PSCO,"5/23/2023 11 p.m. MDT",4560,4507,4827,267
PSCO,"5/24/2023 12 a.m. MDT",4182,4166,4547,365
PSCO,"5/24/2023 1 a.m. MDT",3882,3993,4205,323
PSCO,"5/24/2023 2 a.m. MDT",3925,3771,4111,186
PSCO,"5/24/2023 3 a.m. MDT",3799,3606,4016,217
PSCO,"5/24/2023 4 a.m. MDT",3759,3625,4068,309
PSCO,"5/24/2023 5 a.m. MDT",3853,3700,4124,271
PSCO,"5/24/2023 6 a.m. MDT",3849,3894,4117,268
PSCO,"5/24/2023 7 a.m. MDT",4091,4070,4383,292
PSCO,"5/24/2023 8 a.m. MDT",4246,4181,4502,256
PSCO,"5/24/2023 9 a.m. MDT",4332,4280,4441,109
PSCO,"5/24/2023 10 a.m. MDT",4363,4452,4675,312
PSCO,"5/24/2023 11 a.m. MDT",4451,4482,5136,685
PSCO,"5/24/2023 12 p.m. MDT",4540,4560,5198,658
PSCO,"5/24/2023 1 p.m. MDT",4598,4758,5192,594
PSCO,"5/24/2023 2 p.m. MDT",4954,4884,5430,476
PSCO,"5/24/2023 3 p.m. MDT",5002,4949,5604,602
PSCO,"5/24/2023 4 p.m. MDT",5037,4929,5387,350
PSCO,"5/24/2023 5 p.m. MDT",4955,4941,5186,231
PSCO,"5/24/2023 6 p.m. MDT",4890,4917,4962,72
PSCO,"5/24/2023 7 p.m. MDT",4851,4823,5045,194
PSCO,"5/24/2023 8 p.m. MDT",4902,4653,5054,152
PSCO,"5/24/2023 9 p.m. MDT",4888,4711,4949,61
PSCO,"5/24/2023 10 p.m. MDT",4691,4623,4752,61
PSCO,"5/24/2023 11 p.m. MDT",4358,4340,4626,268
PSCO,"5/25/2023 12 a.m. MDT",4030,3997,4428,398
PSCO,"5/25/2023 1 a.m. MDT",3885,3835,4135,250
PSCO,"5/25/2023 2 a.m. MDT",3732,3667,3895,163
PSCO,"5/25/2023 3 a.m. MDT",3568,3570,3795,227
PSCO,"5/25/2023 4 a.m. MDT",3576,3528,4048,472
PSCO,"5/25/2023 5 a.m. MDT",3639,3605,4173,534
PSCO,"5/25/2023 6 a.m. MDT",3744,3783,4235,491
PSCO,"5/25/2023 7 a.m. MDT",3902,4012,4400,498
PSCO,"5/25/2023 8 a.m. MDT",4001,4126,4460,459
PSCO,"5/25/2023 9 a.m. MDT",4019,4183,4463,444
PSCO,"5/25/2023 10 a.m. MDT",4129,4210,4581,452
PSCO,"5/25/2023 11 a.m. MDT",4343,4289,4823,480
PSCO,"5/25/2023 12 p.m. MDT",4413,4404,4992,579
PSCO,"5/25/2023 1 p.m. MDT",4540,4577,5074,534
PSCO,"5/25/2023 2 p.m. MDT",4678,4719,5330,652
PSCO,"5/25/2023 3 p.m. MDT",4829,4790,5542,713
PSCO,"5/25/2023 4 p.m. MDT",5066,4911,5860,794
PSCO,"5/25/2023 5 p.m. MDT",5276,5017,6058,782
PSCO,"5/25/2023 6 p.m. MDT",5145,5092,6001,856
PSCO,"5/25/2023 7 p.m. MDT",5022,4994,5807,785
PSCO,"5/25/2023 8 p.m. MDT",4790,4881,5403,613
PSCO,"5/25/2023 9 p.m. MDT",4799,4934,5344,545
PSCO,"5/25/2023 10 p.m. MDT",4694,4758,5165,471
PSCO,"5/25/2023 11 p.m. MDT",4373,4421,4639,266
PSCO,"5/26/2023 12 a.m. MDT",4048,4084,4482,434
PSCO,"5/26/2023 1 a.m. MDT",3745,3939,4123,378
PSCO,"5/26/2023 2 a.m. MDT",3673,3780,4091,418
PSCO,"5/26/2023 3 a.m. MDT",3599,3692,3915,316
PSCO,"5/26/2023 4 a.m. MDT",3583,3635,3933,350
PSCO,"5/26/2023 5 a.m. MDT",3622,3703,3955,333
PSCO,"5/26/2023 6 a.m. MDT",3816,3863,4057,241
PSCO,"5/26/2023 7 a.m. MDT",4048,4023,4302,254
PSCO,"5/26/2023 8 a.m. MDT",4314,4128,4581,267
PSCO,"5/26/2023 9 a.m. MDT",4440,4261,4693,253
PSCO,"5/26/2023 10 a.m. MDT",4483,4215,4770,287
PSCO,"5/26/2023 11 a.m. MDT",4629,4324,4801,172
PSCO,"5/26/2023 12 p.m. MDT",4774,4450,4985,211
PSCO,"5/26/2023 1 p.m. MDT",4981,4693,5134,153
PSCO,"5/26/2023 2 p.m. MDT",5303,4814,5613,310
PSCO,"5/26/2023 3 p.m. MDT",5329,4794,5720,391
PSCO,"5/26/2023 4 p.m. MDT",5054,4755,5584,530
PSCO,"5/26/2023 5 p.m. MDT",4912,4734,5393,481
PSCO,"5/26/2023 6 p.m. MDT",5073,4773,5342,269
PSCO,"5/26/2023 7 p.m. MDT",4791,4715,4946,155
PSCO,"5/26/2023 8 p.m. MDT",4780,4578,4730,-50
PSCO,"5/26/2023 9 p.m. MDT",4911,4574,5055,144
PSCO,"5/26/2023 10 p.m. MDT",4689,4466,5059,370
PSCO,"5/26/2023 11 p.m. MDT",4302,4314,4364,62
PSCO,"5/27/2023 12 a.m. MDT",4033,3997,4278,245
PSCO,"5/27/2023 1 a.m. MDT",3758,3878,3758,0
PSCO,"5/27/2023 2 a.m. MDT",3623,3755,3836,213
PSCO,"5/27/2023 3 a.m. MDT",3508,3604,3716,208
PSCO,"5/27/2023 4 a.m. MDT",3456,3590,3819,363
PSCO,"5/27/2023 5 a.m. MDT",3459,3585,3753,294
PSCO,"5/27/2023 6 a.m. MDT",3547,3617,3840,293
PSCO,"5/27/2023 7 a.m. MDT",3617,3611,3945,328
PSCO,"5/27/2023 8 a.m. MDT",3752,3656,3962,210
PSCO,"5/27/2023 9 a.m. MDT",3848,3734,4136,288
PSCO,"5/27/2023 10 a.m. MDT",3878,3749,4103,225
PSCO,"5/27/2023 11 a.m. MDT",3920,3761,4168,248
PSCO,"5/27/2023 12 p.m. MDT",4027,3912,4277,250
PSCO,"5/27/2023 1 p.m. MDT",4049,4025,4299,250
PSCO,"5/27/2023 2 p.m. MDT",4334,4123,4599,265
PSCO,"5/27/2023 3 p.m. MDT",4531,4216,4851,320
PSCO,"5/27/2023 4 p.m. MDT",4554,4313,5068,514
PSCO,"5/27/2023 5 p.m. MDT",4715,4398,5173,458
PSCO,"5/27/2023 6 p.m. MDT",4726,4489,5157,431
PSCO,"5/27/2023 7 p.m. MDT",4823,4552,5240,417
PSCO,"5/27/2023 8 p.m. MDT",4579,4426,5070,491
PSCO,"5/27/2023 9 p.m. MDT",4579,4488,5182,603
PSCO,"5/27/2023 10 p.m. MDT",4493,4375,5086,593
PSCO,"5/27/2023 11 p.m. MDT",4256,4083,4534,278
PSCO,"5/28/2023 12 a.m. MDT",3998,3863,4136,138
PSCO,"5/28/2023 1 a.m. MDT",3763,3712,4208,445
PSCO,"5/28/2023 2 a.m. MDT",3613,3568,3847,234
PSCO,"5/28/2023 3 a.m. MDT",3525,3499,3593,68
PSCO,"5/28/2023 4 a.m. MDT",3457,3419,3304,-153
PSCO,"5/28/2023 5 a.m. MDT",3470,3391,3151,-319
PSCO,"5/28/2023 6 a.m. MDT",3487,3367,3045,-442
PSCO,"5/28/2023 7 a.m. MDT",3564,3393,3248,-316
PSCO,"5/28/2023 8 a.m. MDT",3661,3447,3632,-29
PSCO,"5/28/2023 9 a.m. MDT",3776,3522,3835,59
PSCO,"5/28/2023 10 a.m. MDT",3827,3573,3827,0
PSCO,"5/28/2023 11 a.m. MDT",3903,3700,3999,96
PSCO,"5/28/2023 12 p.m. MDT",3973,3809,4118,145
PSCO,"5/28/2023 1 p.m. MDT",4112,4027,4210,98
PSCO,"5/28/2023 2 p.m. MDT",4236,4150,4187,-49
PSCO,"5/28/2023 3 p.m. MDT",4387,4316,4382,-5
PSCO,"5/28/2023 4 p.m. MDT",4555,4396,4797,242
PSCO,"5/28/2023 5 p.m. MDT",4739,4559,5121,382
PSCO,"5/28/2023 6 p.m. MDT",4940,4695,5395,455
PSCO,"5/28/2023 7 p.m. MDT",4900,4738,5104,204
PSCO,"5/28/2023 8 p.m. MDT",4696,4684,4720,24
PSCO,"5/28/2023 9 p.m. MDT",4665,4661,5007,342
PSCO,"5/28/2023 10 p.m. MDT",4564,4600,4957,393
PSCO,"5/28/2023 11 p.m. MDT",4305,4283,4598,293
PSCO,"5/29/2023 12 a.m. MDT",3993,3961,4151,158
PSCO,"5/29/2023 1 a.m. MDT",3770,3756,3943,173
PSCO,"5/29/2023 2 a.m. MDT",3604,3597,3792,188
PSCO,"5/29/2023 3 a.m. MDT",3534,3473,3815,281
PSCO,"5/29/2023 4 a.m. MDT",3487,3402,3801,314
PSCO,"5/29/2023 5 a.m. MDT",3523,3383,3772,249
PSCO,"5/29/2023 6 a.m. MDT",3556,3374,3634,78
PSCO,"5/29/2023 7 a.m. MDT",3596,3406,3824,228
PSCO,"5/29/2023 8 a.m. MDT",3742,3445,4031,289
PSCO,"5/29/2023 9 a.m. MDT",3871,3506,4129,258
PSCO,"5/29/2023 10 a.m. MDT",4023,3598,4290,267
PSCO,"5/29/2023 11 a.m. MDT",4128,3754,4462,334
PSCO,"5/29/2023 12 p.m. MDT",4324,3924,4853,529
PSCO,"5/29/2023 1 p.m. MDT",4556,4109,4907,351
PSCO,"5/29/2023 2 p.m. MDT",4706,4302,5054,348
PSCO,"5/29/2023 3 p.m. MDT",4882,4472,5193,311
PSCO,"5/29/2023 4 p.m. MDT",5140,4638,5541,401
PSCO,"5/29/2023 5 p.m. MDT",5420,4824,5846,426
PSCO,"5/29/2023 6 p.m. MDT",5501,4961,5655,154
PSCO,"5/29/2023 7 p.m. MDT",5351,5061,5646,295
PSCO,"5/29/2023 8 p.m. MDT",5266,4820,5441,175
PSCO,"5/29/2023 9 p.m. MDT",5163,4701,5095,-68
PSCO,"5/29/2023 10 p.m. MDT",4956,4586,4996,40
PSCO,"5/29/2023 11 p.m. MDT",4566,4298,4669,103
PSCO,"5/30/2023 12 a.m. MDT",4131,3980,4289,158
PSCO,"5/30/2023 1 a.m. MDT",3868,3855,3914,46
PSCO,"5/30/2023 2 a.m. MDT",3684,3650,3893,209
PSCO,"5/30/2023 3 a.m. MDT",3572,3508,3651,79
PSCO,"5/30/2023 4 a.m. MDT",3543,3463,3642,99
PSCO,"5/30/2023 5 a.m. MDT",3612,3515,3666,54
PSCO,"5/30/2023 6 a.m. MDT",3760,3695,3868,108
PSCO,"5/30/2023 7 a.m. MDT",3975,3883,4382,407
PSCO,"5/30/2023 8 a.m. MDT",4257,4047,4838,581
PSCO,"5/30/2023 9 a.m. MDT",4445,4102,4941,496
PSCO,"5/30/2023 10 a.m. MDT",4505,4184,4901,396
PSCO,"5/30/2023 11 a.m. MDT",4701,4359,4831,130
PSCO,"5/30/2023 12 p.m. MDT",4894,4561,4917,23
PSCO,"5/30/2023 1 p.m. MDT",5134,4788,5106,-28
PSCO,"5/30/2023 2 p.m. MDT",5428,5073,5502,74
PSCO,"5/30/2023 3 p.m. MDT",5364,5284,5462,98
PSCO,"5/30/2023 4 p.m. MDT",5225,5492,5261,36
PSCO,"5/30/2023 5 p.m. MDT",5189,5532,5538,349
PSCO,"5/30/2023 6 p.m. MDT",5328,5573,6265,937
PSCO,"5/30/2023 7 p.m. MDT",5200,5432,5867,667
PSCO,"5/30/2023 8 p.m. MDT",5116,5359,5699,583
PSCO,"5/30/2023 9 p.m. MDT",5051,5251,5263,212
PSCO,"5/30/2023 10 p.m. MDT",4890,5042,5103,213
PSCO,"5/30/2023 11 p.m. MDT",4543,4675,4985,442
PSCO,"5/31/2023 12 a.m. MDT",4177,4252,4612,435
PSCO,"5/31/2023 1 a.m. MDT",3939,3896,4263,324
PSCO,"5/31/2023 2 a.m. MDT",3769,3717,3945,176
PSCO,"5/31/2023 3 a.m. MDT",3641,3657,3802,161
PSCO,"5/31/2023 4 a.m. MDT",3610,3585,3847,237
PSCO,"5/31/2023 5 a.m. MDT",3666,3619,3979,313
PSCO,"5/31/2023 6 a.m. MDT",3767,3763,4113,346
PSCO,"5/31/2023 7 a.m. MDT",3995,3961,4372,377
PSCO,"5/31/2023 8 a.m. MDT",4156,4133,4456,300
PSCO,"5/31/2023 9 a.m. MDT",4350,4269,4729,379
PSCO,"5/31/2023 10 a.m. MDT",4431,4346,4821,390
PSCO,"5/31/2023 11 a.m. MDT",4549,4487,4701,152
PSCO,"5/31/2023 12 p.m. MDT",4732,4640,5001,269
PSCO,"5/31/2023 1 p.m. MDT",4969,4835,5523,554
PSCO,"5/31/2023 2 p.m. MDT",5278,5021,5881,603
PSCO,"5/31/2023 3 p.m. MDT",5429,5107,5996,567
PSCO,"5/31/2023 4 p.m. MDT",5276,5217,5854,578
PSCO,"5/31/2023 5 p.m. MDT",5055,5203,5640,585
PSCO,"5/31/2023 6 p.m. MDT",5051,5188,5496,445
PSCO,"5/31/2023 7 p.m. MDT",5012,5103,5639,627
PSCO,"5/31/2023 8 p.m. MDT",4979,4979,5419,440
PSCO,"5/31/2023 9 p.m. MDT",4910,4905,5222,312
PSCO,"5/31/2023 10 p.m. MDT",4720,4803,5342,622
PSCO,"5/31/2023 11 p.m. MDT",4381,4455,4916,535
PSCO,"6/1/2023 12 a.m. MDT",4049,4096,4389,340
