"BA Code","Timestamp (Hour Ending)","Demand (MWh)","Demand Forecast (MWh)","Net Generation (MWh)","Total Interchange (MWh)"
PSCO,"11/1/2022 12 a.m. MDT",4034,3925,3890,-144
PSCO,"11/1/2022 1 a.m. MDT",3897,3783,3741,-156
PSCO,"11/1/2022 2 a.m. MDT",3828,3726,3893,65
PSCO,"11/1/2022 3 a.m. MDT",3793,3700,3841,48
PSCO,"11/1/2022 4 a.m. MDT",3826,3733,3766,-60
PSCO,"11/1/2022 5 a.m. MDT",3929,3824,3821,-108
PSCO,"11/1/2022 6 a.m. MDT",4186,4115,4109,-77
PSCO,"11/1/2022 7 a.m. MDT",4641,4508,4651,10
PSCO,"11/1/2022 8 a.m. MDT",4888,4836,4872,-16
PSCO,"11/1/2022 9 a.m. MDT",4763,4677,4760,-3
PSCO,"11/1/2022 10 a.m. MDT",4547,4482,4518,-29
PSCO,"11/1/2022 11 a.m. MDT",4403,4322,4472,69
PSCO,"11/1/2022 12 p.m. MDT",4348,4337,4488,140
PSCO,"11/1/2022 1 p.m. MDT",4334,4278,4518,184
PSCO,"11/1/2022 2 p.m. MDT",4409,4315,4520,111
PSCO,"11/1/2022 3 p.m. MDT",4463,4344,4627,164
PSCO,"11/1/2022 4 p.m. MDT",4624,4387,4743,119
PSCO,"11/1/2022 5 p.m. MDT",4719,4642,4748,29
PSCO,"11/1/2022 6 p.m. MDT",4899,4773,4909,10
PSCO,"11/1/2022 7 p.m. MDT",5028,5014,5002,-26
PSCO,"11/1/2022 8 p.m. MDT",4966,4950,5057,91
PSCO,"11/1/2022 9 p.m. MDT",4818,4789,4923,105
PSCO,"11/1/2022 10 p.m. MDT",4575,4499,4675,100
PSCO,"11/1/2022 11 p.m. MDT",4264,4200,4402,138
PSCO,"11/2/2022 12 a.m. MDT",4003,3933,4210,207
PSCO,"11/2/2022 1 a.m. MDT",3832,3765,4009,177
PSCO,"11/2/2022 2 a.m. MDT",3759,3623,4035,276
PSCO,"11/2/2022 3 a.m. MDT",3709,3604,3968,259
PSCO,"11/2/2022 4 a.m. MDT",3753,3594,4023,270
PSCO,"11/2/2022 5 a.m. MDT",3831,3721,4226,395
PSCO,"11/2/2022 6 a.m. MDT",4089,3987,4552,463
PSCO,"11/2/2022 7 a.m. MDT",4538,4386,4982,444
PSCO,"11/2/2022 8 a.m. MDT",4773,4629,5109,336
PSCO,"11/2/2022 9 a.m. MDT",4746,4599,5055,309
PSCO,"11/2/2022 10 a.m. MDT",4624,4464,4876,252
PSCO,"11/2/2022 11 a.m. MDT",4566,4330,4736,170
PSCO,"11/2/2022 12 p.m. MDT",4470,4285,4711,241
PSCO,"11/2/2022 1 p.m. MDT",4363,4292,4567,204
PSCO,"11/2/2022 2 p.m. MDT",4345,4347,4660,315
PSCO,"11/2/2022 3 p.m. MDT",4381,4367,4594,213
PSCO,"11/2/2022 4 p.m. MDT",4472,4393,4657,185
PSCO,"11/2/2022 5 p.m. MDT",4641,4516,4739,98
PSCO,"11/2/2022 6 p.m. MDT",4848,4776,4954,106
PSCO,"11/2/2022 7 p.m. MDT",4995,4832,5269,274
PSCO,"11/2/2022 8 p.m. MDT",4904,4766,5152,248
PSCO,"11/2/2022 9 p.m. MDT",4755,4685,4960,205
PSCO,"11/2/2022 10 p.m. MDT",4524,4459,4744,220
PSCO,"11/2/2022 11 p.m. MDT",4231,4180,4515,284
PSCO,"11/3/2022 12 a.m. MDT",3989,3926,4355,366
PSCO,"11/3/2022 1 a.m. MDT",3817,3842,4237,420
PSCO,"11/3/2022 2 a.m. MDT",3705,3767,4134,429
PSCO,"11/3/2022 3 a.m. MDT",3664,3706,4142,478
PSCO,"11/3/2022 4 a.m. MDT",3690,3737,3976,286
PSCO,"11/3/2022 5 a.m. MDT",3800,3859,4104,304
PSCO,"11/3/2022 6 a.m. MDT",4030,4140,4298,268
PSCO,"11/3/2022 7 a.m. MDT",4479,4543,4897,418
PSCO,"11/3/2022 8 a.m. MDT",4779,4907,5194,415
PSCO,"11/3/2022 9 a.m. MDT",4731,4858,5243,512
PSCO,"11/3/2022 10 a.m. MDT",4790,4663,4997,207
PSCO,"11/3/2022 11 a.m. MDT",4703,4597,4871,168
PSCO,"11/3/2022 12 p.m. MDT",4783,4572,4953,170
PSCO,"11/3/2022 1 p.m. MDT",4812,4654,4888,76
PSCO,"11/3/2022 2 p.m. MDT",4906,4732,4937,31
PSCO,"11/3/2022 3 p.m. MDT",4907,4745,4925,18
PSCO,"11/3/2022 4 p.m. MDT",4974,4823,4940,-34
PSCO,"11/3/2022 5 p.m. MDT",5154,4925,5058,-96
PSCO,"11/3/2022 6 p.m. MDT",5339,5131,5249,-90
PSCO,"11/3/2022 7 p.m. MDT",5447,5293,5629,182
PSCO,"11/3/2022 8 p.m. MDT",5318,5150,5489,171
PSCO,"11/3/2022 9 p.m. MDT",5183,5026,5459,276
PSCO,"11/3/2022 10 p.m. MDT",4951,4759,5326,375
PSCO,"11/3/2022 11 p.m. MDT",4673,4485,4866,193
PSCO,"11/4/2022 12 a.m. MDT",4380,4253,4652,272
PSCO,"11/4/2022 1 a.m. MDT",4270,4096,4608,338
PSCO,"11/4/2022 2 a.m. MDT",4122,4050,4302,180
PSCO,"11/4/2022 3 a.m. MDT",4086,4017,4182,96
PSCO,"11/4/2022 4 a.m. MDT",4124,4022,4164,40
PSCO,"11/4/2022 5 a.m. MDT",4231,4198,4367,136
PSCO,"11/4/2022 6 a.m. MDT",4451,4396,4693,242
PSCO,"11/4/2022 7 a.m. MDT",4817,4800,5025,208
PSCO,"11/4/2022 8 a.m. MDT",5106,5068,5267,161
PSCO,"11/4/2022 9 a.m. MDT",5140,5073,5192,52
PSCO,"11/4/2022 10 a.m. MDT",5084,5052,5115,31
PSCO,"11/4/2022 11 a.m. MDT",4990,4927,5033,43
PSCO,"11/4/2022 12 p.m. MDT",4803,4770,4878,75
PSCO,"11/4/2022 1 p.m. MDT",4697,4663,4787,90
PSCO,"11/4/2022 2 p.m. MDT",4555,4611,4633,78
PSCO,"11/4/2022 3 p.m. MDT",4443,4563,4504,61
PSCO,"11/4/2022 4 p.m. MDT",4437,4509,4505,68
PSCO,"11/4/2022 5 p.m. MDT",4599,4601,4673,74
PSCO,"11/4/2022 6 p.m. MDT",4888,4968,4817,-71
PSCO,"11/4/2022 7 p.m. MDT",5060,5024,4977,-83
PSCO,"11/4/2022 8 p.m. MDT",4980,4981,4891,-89
PSCO,"11/4/2022 9 p.m. MDT",4893,4901,4819,-74
PSCO,"11/4/2022 10 p.m. MDT",4800,4684,4798,-2
PSCO,"11/4/2022 11 p.m. MDT",4543,4495,4699,156
PSCO,"11/5/2022 12 a.m. MDT",4347,4295,4534,187
PSCO,"11/5/2022 1 a.m. MDT",4149,4158,4397,248
PSCO,"11/5/2022 2 a.m. MDT",4116,4015,4318,202
PSCO,"11/5/2022 3 a.m. MDT",4068,3989,4261,193
PSCO,"11/5/2022 4 a.m. MDT",4026,4005,4330,304
PSCO,"11/5/2022 5 a.m. MDT",4042,4113,4351,309
PSCO,"11/5/2022 6 a.m. MDT",4123,4194,4472,349
PSCO,"11/5/2022 7 a.m. MDT",4308,4405,4568,260
PSCO,"11/5/2022 8 a.m. MDT",4490,4567,4792,302
PSCO,"11/5/2022 9 a.m. MDT",4546,4555,4826,280
PSCO,"11/5/2022 10 a.m. MDT",4543,4406,4811,268
PSCO,"11/5/2022 11 a.m. MDT",4598,4289,4858,260
PSCO,"11/5/2022 12 p.m. MDT",4547,4123,4773,226
PSCO,"11/5/2022 1 p.m. MDT",4410,3952,4518,108
PSCO,"11/5/2022 2 p.m. MDT",4213,3893,4321,108
PSCO,"11/5/2022 3 p.m. MDT",4136,3853,4147,11
PSCO,"11/5/2022 4 p.m. MDT",4214,3927,4189,-25
PSCO,"11/5/2022 5 p.m. MDT",4307,4081,4202,-105
PSCO,"11/5/2022 6 p.m. MDT",4603,4334,4438,-165
PSCO,"11/5/2022 7 p.m. MDT",4846,4601,4682,-164
PSCO,"11/5/2022 8 p.m. MDT",4722,4533,4686,-36
PSCO,"11/5/2022 9 p.m. MDT",4646,4435,4660,14
PSCO,"11/5/2022 10 p.m. MDT",4496,4359,4556,60
PSCO,"11/5/2022 11 p.m. MDT",4295,4192,4365,70
PSCO,"11/6/2022 12 a.m. MDT",4060,4127,4214,154
PSCO,"11/6/2022 1 a.m. MDT",3905,3899,4109,204
PSCO,"11/6/2022 1 a.m. MST",3789,3685,4022,233
PSCO,"11/6/2022 2 a.m. MST",3745,0,3844,99
PSCO,"11/6/2022 3 a.m. MST",3740,3773,3886,146
PSCO,"11/6/2022 4 a.m. MST",3753,3798,3907,154
PSCO,"11/6/2022 5 a.m. MST",3808,3839,3959,151
PSCO,"11/6/2022 6 a.m. MST",3944,3965,4164,220
PSCO,"11/6/2022 7 a.m. MST",4123,4157,4479,356
PSCO,"11/6/2022 8 a.m. MST",4231,4259,4518,287
PSCO,"11/6/2022 9 a.m. MST",4327,4367,4452,125
PSCO,"11/6/2022 10 a.m. MST",4303,4322,4345,42
PSCO,"11/6/2022 11 a.m. MST",4363,4201,4368,5
PSCO,"11/6/2022 12 p.m. MST",4433,4214,4409,-24
PSCO,"11/6/2022 1 p.m. MST",4296,4246,4260,-36
PSCO,"11/6/2022 2 p.m. MST",4435,4277,4397,-38
PSCO,"11/6/2022 3 p.m. MST",4483,4350,4544,61
PSCO,"11/6/2022 4 p.m. MST",4557,4475,4590,33
PSCO,"11/6/2022 5 p.m. MST",4807,4654,4901,94
PSCO,"11/6/2022 6 p.m. MST",5091,5049,5150,59
PSCO,"11/6/2022 7 p.m. MST",5028,4978,5085,57
PSCO,"11/6/2022 8 p.m. MST",4969,4857,5014,45
PSCO,"11/6/2022 9 p.m. MST",4805,4646,4910,105
PSCO,"11/6/2022 10 p.m. MST",4609,4406,4695,86
PSCO,"11/6/2022 11 p.m. MST",4334,4175,4487,153
PSCO,"11/7/2022 12 a.m. MST",4120,3996,4299,179
PSCO,"11/7/2022 1 a.m. MST",3955,3607,4090,135
PSCO,"11/7/2022 2 a.m. MST",3903,3608,4070,167
PSCO,"11/7/2022 3 a.m. MST",3965,3643,4123,158
PSCO,"11/7/2022 4 a.m. MST",3999,3762,4156,157
PSCO,"11/7/2022 5 a.m. MST",4142,4047,4287,145
PSCO,"11/7/2022 6 a.m. MST",4418,4470,4688,270
PSCO,"11/7/2022 7 a.m. MST",4797,4606,5070,273
PSCO,"11/7/2022 8 a.m. MST",4842,4533,5179,337
PSCO,"11/7/2022 9 a.m. MST",4725,4330,4859,134
PSCO,"11/7/2022 10 a.m. MST",4507,4223,4438,-69
PSCO,"11/7/2022 11 a.m. MST",4416,4191,4363,-53
PSCO,"11/7/2022 12 p.m. MST",4376,4176,4365,-11
PSCO,"11/7/2022 1 p.m. MST",4311,4222,4374,63
PSCO,"11/7/2022 2 p.m. MST",4356,4211,4429,73
PSCO,"11/7/2022 3 p.m. MST",4410,4334,4471,61
PSCO,"11/7/2022 4 p.m. MST",4592,4520,4660,68
PSCO,"11/7/2022 5 p.m. MST",4810,4879,4809,-1
PSCO,"11/7/2022 6 p.m. MST",5204,4800,5162,-42
PSCO,"11/7/2022 7 p.m. MST",5113,4647,5108,-5
PSCO,"11/7/2022 8 p.m. MST",4958,4494,4961,3
PSCO,"11/7/2022 9 p.m. MST",4816,4253,4837,21
PSCO,"11/7/2022 10 p.m. MST",4543,3982,4704,161
PSCO,"11/7/2022 11 p.m. MST",4245,3735,4442,197
PSCO,"11/8/2022 12 a.m. MST",4051,3619,4261,210
PSCO,"11/8/2022 1 a.m. MST",3904,3654,4470,566
PSCO,"11/8/2022 2 a.m. MST",3801,3577,4347,546
PSCO,"11/8/2022 3 a.m. MST",3825,3584,4350,525
PSCO,"11/8/2022 4 a.m. MST",3786,3607,4275,489
PSCO,"11/8/2022 5 a.m. MST",3949,3705,4459,510
PSCO,"11/8/2022 6 a.m. MST",4175,3991,4653,478
PSCO,"11/8/2022 7 a.m. MST",4564,4411,4877,313
PSCO,"11/8/2022 8 a.m. MST",4662,4455,4933,271
PSCO,"11/8/2022 9 a.m. MST",4566,4434,4839,273
PSCO,"11/8/2022 10 a.m. MST",4469,4235,4702,233
PSCO,"11/8/2022 11 a.m. MST",4335,4132,4567,232
PSCO,"11/8/2022 12 p.m. MST",4308,4102,4548,240
PSCO,"11/8/2022 1 p.m. MST",4248,4089,4471,223
PSCO,"11/8/2022 2 p.m. MST",4371,4127,4609,238
PSCO,"11/8/2022 3 p.m. MST",4415,4166,4685,270
PSCO,"11/8/2022 4 p.m. MST",4551,4262,4780,229
PSCO,"11/8/2022 5 p.m. MST",4759,4452,5005,246
PSCO,"11/8/2022 6 p.m. MST",4952,4817,5396,444
PSCO,"11/8/2022 7 p.m. MST",4900,4720,5262,362
PSCO,"11/8/2022 8 p.m. MST",4784,4582,5161,377
PSCO,"11/8/2022 9 p.m. MST",4675,4444,4971,296
PSCO,"11/8/2022 10 p.m. MST",4470,4222,4758,288
PSCO,"11/8/2022 11 p.m. MST",4193,3954,4582,389
PSCO,"11/9/2022 12 a.m. MST",4004,3732,4358,354
PSCO,"11/9/2022 1 a.m. MST",3861,4021,4363,502
PSCO,"11/9/2022 2 a.m. MST",3806,4015,4469,663
PSCO,"11/9/2022 3 a.m. MST",3778,3950,4466,688
PSCO,"11/9/2022 4 a.m. MST",3786,3895,4421,635
PSCO,"11/9/2022 5 a.m. MST",3949,4089,4624,675
PSCO,"11/9/2022 6 a.m. MST",4264,4353,4926,662
PSCO,"11/9/2022 7 a.m. MST",4599,4718,5211,612
PSCO,"11/9/2022 8 a.m. MST",4724,4855,5234,510
PSCO,"11/9/2022 9 a.m. MST",4587,4784,5111,524
PSCO,"11/9/2022 10 a.m. MST",4527,4561,5019,492
PSCO,"11/9/2022 11 a.m. MST",4410,4481,4911,501
PSCO,"11/9/2022 12 p.m. MST",4355,4420,4727,372
PSCO,"11/9/2022 1 p.m. MST",4321,4441,4639,318
PSCO,"11/9/2022 2 p.m. MST",4374,4469,4701,327
PSCO,"11/9/2022 3 p.m. MST",4447,4559,4715,268
PSCO,"11/9/2022 4 p.m. MST",4616,4668,4896,280
PSCO,"11/9/2022 5 p.m. MST",4877,4810,5077,200
PSCO,"11/9/2022 6 p.m. MST",5182,5125,5435,253
PSCO,"11/9/2022 7 p.m. MST",5212,5054,5453,241
PSCO,"11/9/2022 8 p.m. MST",5143,4913,5435,292
PSCO,"11/9/2022 9 p.m. MST",5009,4793,5340,331
PSCO,"11/9/2022 10 p.m. MST",4764,4610,5245,481
PSCO,"11/9/2022 11 p.m. MST",4452,4370,5005,553
PSCO,"11/10/2022 12 a.m. MST",4237,4177,4747,510
PSCO,"11/10/2022 1 a.m. MST",4081,4121,4713,632
PSCO,"11/10/2022 2 a.m. MST",3996,3990,4670,674
PSCO,"11/10/2022 3 a.m. MST",4014,3960,4707,693
PSCO,"11/10/2022 4 a.m. MST",4042,4001,4705,663
PSCO,"11/10/2022 5 a.m. MST",4187,4247,4744,557
PSCO,"11/10/2022 6 a.m. MST",4464,4570,4892,428
PSCO,"11/10/2022 7 a.m. MST",4820,4938,5246,426
PSCO,"11/10/2022 8 a.m. MST",4846,5119,5396,550
PSCO,"11/10/2022 9 a.m. MST",4668,5106,5229,561
PSCO,"11/10/2022 10 a.m. MST",4555,4918,5330,775
PSCO,"11/10/2022 11 a.m. MST",4456,4776,5239,783
PSCO,"11/10/2022 12 p.m. MST",4416,4614,5158,742
PSCO,"11/10/2022 1 p.m. MST",4363,4558,5025,662
PSCO,"11/10/2022 2 p.m. MST",4397,4502,4963,566
PSCO,"11/10/2022 3 p.m. MST",4477,4554,5037,560
PSCO,"11/10/2022 4 p.m. MST",4665,4716,5198,533
PSCO,"11/10/2022 5 p.m. MST",5028,5027,5565,537
PSCO,"11/10/2022 6 p.m. MST",5410,5335,6169,759
PSCO,"11/10/2022 7 p.m. MST",5435,5340,6115,680
PSCO,"11/10/2022 8 p.m. MST",5343,5228,6011,668
PSCO,"11/10/2022 9 p.m. MST",5134,5094,5818,684
PSCO,"11/10/2022 10 p.m. MST",4871,4903,5686,815
PSCO,"11/10/2022 11 p.m. MST",4663,4649,5331,668
PSCO,"11/11/2022 12 a.m. MST",4463,4342,4981,518
PSCO,"11/11/2022 1 a.m. MST",4303,4222,4724,421
PSCO,"11/11/2022 2 a.m. MST",4251,4200,4561,310
PSCO,"11/11/2022 3 a.m. MST",4259,4232,4505,246
PSCO,"11/11/2022 4 a.m. MST",4296,4305,4562,266
PSCO,"11/11/2022 5 a.m. MST",4406,4279,4623,217
PSCO,"11/11/2022 6 a.m. MST",4672,4515,4662,-10
PSCO,"11/11/2022 7 a.m. MST",5012,4868,4943,-69
PSCO,"11/11/2022 8 a.m. MST",5120,4982,5111,-9
PSCO,"11/11/2022 9 a.m. MST",5082,5005,5100,18
PSCO,"11/11/2022 10 a.m. MST",4902,4817,5076,174
PSCO,"11/11/2022 11 a.m. MST",4703,4707,5013,310
PSCO,"11/11/2022 12 p.m. MST",4569,4672,4763,194
PSCO,"11/11/2022 1 p.m. MST",4524,4597,4695,171
PSCO,"11/11/2022 2 p.m. MST",4523,4582,4743,220
PSCO,"11/11/2022 3 p.m. MST",4562,4631,4710,148
PSCO,"11/11/2022 4 p.m. MST",4690,4652,4624,-66
PSCO,"11/11/2022 5 p.m. MST",5074,4934,5081,7
PSCO,"11/11/2022 6 p.m. MST",5375,5375,5378,3
PSCO,"11/11/2022 7 p.m. MST",5317,5340,5341,24
PSCO,"11/11/2022 8 p.m. MST",5205,5157,5215,10
PSCO,"11/11/2022 9 p.m. MST",5102,5056,5072,-30
PSCO,"11/11/2022 10 p.m. MST",4903,4936,5012,109
PSCO,"11/11/2022 11 p.m. MST",4675,4690,4814,139
PSCO,"11/12/2022 12 a.m. MST",4537,4541,4671,134
PSCO,"11/12/2022 1 a.m. MST",4409,4488,4808,399
PSCO,"11/12/2022 2 a.m. MST",4309,4374,4704,395
PSCO,"11/12/2022 3 a.m. MST",4304,4324,4680,376
PSCO,"11/12/2022 4 a.m. MST",4303,4323,4642,339
PSCO,"11/12/2022 5 a.m. MST",4350,4327,4596,246
PSCO,"11/12/2022 6 a.m. MST",4489,4449,4650,161
PSCO,"11/12/2022 7 a.m. MST",4688,4636,4905,217
PSCO,"11/12/2022 8 a.m. MST",4635,4705,4886,251
PSCO,"11/12/2022 9 a.m. MST",4507,4695,4757,250
PSCO,"11/12/2022 10 a.m. MST",4418,4633,4632,214
PSCO,"11/12/2022 11 a.m. MST",4343,4528,4503,160
PSCO,"11/12/2022 12 p.m. MST",4288,4324,4382,94
PSCO,"11/12/2022 1 p.m. MST",4159,4268,4214,55
PSCO,"11/12/2022 2 p.m. MST",4157,4292,4261,104
PSCO,"11/12/2022 3 p.m. MST",4264,4384,4359,95
PSCO,"11/12/2022 4 p.m. MST",4401,4552,4539,138
PSCO,"11/12/2022 5 p.m. MST",4743,4861,4859,116
PSCO,"11/12/2022 6 p.m. MST",5142,5163,5459,317
PSCO,"11/12/2022 7 p.m. MST",5146,5097,5450,304
PSCO,"11/12/2022 8 p.m. MST",5081,5016,5452,371
PSCO,"11/12/2022 9 p.m. MST",4988,4914,5305,317
PSCO,"11/12/2022 10 p.m. MST",4855,4752,5100,245
PSCO,"11/12/2022 11 p.m. MST",4604,4557,4857,253
PSCO,"11/13/2022 12 a.m. MST",4476,4468,4663,187
PSCO,"11/13/2022 1 a.m. MST",4335,4351,4462,127
PSCO,"11/13/2022 2 a.m. MST",4258,4236,4432,174
PSCO,"11/13/2022 3 a.m. MST",4243,4268,4436,193
PSCO,"11/13/2022 4 a.m. MST",4241,4220,4469,228
PSCO,"11/13/2022 5 a.m. MST",4249,4264,4445,196
PSCO,"11/13/2022 6 a.m. MST",4343,4414,4565,222
PSCO,"11/13/2022 7 a.m. MST",4491,4523,4714,223
PSCO,"11/13/2022 8 a.m. MST",4503,4535,4865,362
PSCO,"11/13/2022 9 a.m. MST",4364,4561,4690,326
PSCO,"11/13/2022 10 a.m. MST",4352,4509,4604,252
PSCO,"11/13/2022 11 a.m. MST",4389,4462,4541,152
PSCO,"11/13/2022 12 p.m. MST",4365,4428,4482,117
PSCO,"11/13/2022 1 p.m. MST",4387,4368,4442,55
PSCO,"11/13/2022 2 p.m. MST",4369,4398,4506,137
PSCO,"11/13/2022 3 p.m. MST",4383,4501,4533,150
PSCO,"11/13/2022 4 p.m. MST",4569,4607,4821,252
PSCO,"11/13/2022 5 p.m. MST",4950,4821,5098,148
PSCO,"11/13/2022 6 p.m. MST",5318,5355,5548,230
PSCO,"11/13/2022 7 p.m. MST",5313,5248,5464,151
PSCO,"11/13/2022 8 p.m. MST",5234,5090,5284,50
PSCO,"11/13/2022 9 p.m. MST",5108,4990,5204,96
PSCO,"11/13/2022 10 p.m. MST",4900,4770,5088,188
PSCO,"11/13/2022 11 p.m. MST",4615,4510,4804,189
PSCO,"11/14/2022 12 a.m. MST",4382,4365,4581,199
PSCO,"11/14/2022 1 a.m. MST",4276,4265,4425,149
PSCO,"11/14/2022 2 a.m. MST",4217,4161,4432,215
PSCO,"11/14/2022 3 a.m. MST",4245,4213,4516,271
PSCO,"11/14/2022 4 a.m. MST",4292,4271,4502,210
PSCO,"11/14/2022 5 a.m. MST",4443,4407,4698,255
PSCO,"11/14/2022 6 a.m. MST",4727,4701,5034,307
PSCO,"11/14/2022 7 a.m. MST",5164,5106,5245,81
PSCO,"11/14/2022 8 a.m. MST",5238,5267,5406,168
PSCO,"11/14/2022 9 a.m. MST",5077,5219,5315,238
PSCO,"11/14/2022 10 a.m. MST",5077,5013,5373,296
PSCO,"11/14/2022 11 a.m. MST",4992,4898,5199,207
PSCO,"11/14/2022 12 p.m. MST",4894,4852,5048,154
PSCO,"11/14/2022 1 p.m. MST",4840,4826,5036,196
PSCO,"11/14/2022 2 p.m. MST",4865,4789,4925,60
PSCO,"11/14/2022 3 p.m. MST",4933,4817,4900,-33
PSCO,"11/14/2022 4 p.m. MST",5059,4959,4951,-108
PSCO,"11/14/2022 5 p.m. MST",5393,5213,5252,-141
PSCO,"11/14/2022 6 p.m. MST",5756,5640,5425,-331
PSCO,"11/14/2022 7 p.m. MST",5668,5612,5313,-355
PSCO,"11/14/2022 8 p.m. MST",5541,5457,5269,-272
PSCO,"11/14/2022 9 p.m. MST",5370,5344,5164,-206
PSCO,"11/14/2022 10 p.m. MST",5075,5098,5059,-16
PSCO,"11/14/2022 11 p.m. MST",4761,4761,4916,155
PSCO,"11/15/2022 12 a.m. MST",4523,4560,4759,236
PSCO,"11/15/2022 1 a.m. MST",4374,4374,4597,223
PSCO,"11/15/2022 2 a.m. MST",4340,4350,4570,230
PSCO,"11/15/2022 3 a.m. MST",4353,4443,4671,318
PSCO,"11/15/2022 4 a.m. MST",4415,4538,4742,327
PSCO,"11/15/2022 5 a.m. MST",4553,4679,4783,230
PSCO,"11/15/2022 6 a.m. MST",4783,4772,5035,252
PSCO,"11/15/2022 7 a.m. MST",5194,5223,5472,278
PSCO,"11/15/2022 8 a.m. MST",5358,5391,5681,323
PSCO,"11/15/2022 9 a.m. MST",5344,5394,5604,260
PSCO,"11/15/2022 10 a.m. MST",5237,5188,5423,186
PSCO,"11/15/2022 11 a.m. MST",5092,5025,5227,135
PSCO,"11/15/2022 12 p.m. MST",5017,4807,5324,307
PSCO,"11/15/2022 1 p.m. MST",4963,4746,5342,379
PSCO,"11/15/2022 2 p.m. MST",5032,4763,5356,324
PSCO,"11/15/2022 3 p.m. MST",5035,4748,5422,387
PSCO,"11/15/2022 4 p.m. MST",5170,4896,5615,445
PSCO,"11/15/2022 5 p.m. MST",5475,5207,5841,366
PSCO,"11/15/2022 6 p.m. MST",5787,5707,6066,279
PSCO,"11/15/2022 7 p.m. MST",5752,5676,5937,185
PSCO,"11/15/2022 8 p.m. MST",5623,5558,5787,164
PSCO,"11/15/2022 9 p.m. MST",5489,5409,5672,183
PSCO,"11/15/2022 10 p.m. MST",5241,5183,5554,313
PSCO,"11/15/2022 11 p.m. MST",4930,4886,5344,414
PSCO,"11/16/2022 12 a.m. MST",4697,4778,5109,412
PSCO,"11/16/2022 1 a.m. MST",4599,4623,5076,477
PSCO,"11/16/2022 2 a.m. MST",4582,4482,4997,415
PSCO,"11/16/2022 3 a.m. MST",4594,4545,5117,523
PSCO,"11/16/2022 4 a.m. MST",4624,4477,5123,499
PSCO,"11/16/2022 5 a.m. MST",4703,4628,5163,460
PSCO,"11/16/2022 6 a.m. MST",4943,4797,5476,533
PSCO,"11/16/2022 7 a.m. MST",5381,5256,5911,530
PSCO,"11/16/2022 8 a.m. MST",5509,5421,6167,658
PSCO,"11/16/2022 9 a.m. MST",5376,5390,6042,666
PSCO,"11/16/2022 10 a.m. MST",5248,5188,5909,661
PSCO,"11/16/2022 11 a.m. MST",5122,5046,5714,592
PSCO,"11/16/2022 12 p.m. MST",4949,4843,5544,595
PSCO,"11/16/2022 1 p.m. MST",4875,4659,5512,637
PSCO,"11/16/2022 2 p.m. MST",4848,4623,5479,631
PSCO,"11/16/2022 3 p.m. MST",4885,4655,5497,612
PSCO,"11/16/2022 4 p.m. MST",5035,4797,5736,701
PSCO,"11/16/2022 5 p.m. MST",5354,5133,5828,474
PSCO,"11/16/2022 6 p.m. MST",5706,5672,5829,123
PSCO,"11/16/2022 7 p.m. MST",5676,5624,5709,33
PSCO,"11/16/2022 8 p.m. MST",5582,5498,5653,71
PSCO,"11/16/2022 9 p.m. MST",5439,5378,5519,80
PSCO,"11/16/2022 10 p.m. MST",5169,5155,5319,150
PSCO,"11/16/2022 11 p.m. MST",4866,4867,5229,363
PSCO,"11/17/2022 12 a.m. MST",4743,4746,5049,306
PSCO,"11/17/2022 1 a.m. MST",4568,4555,5005,437
PSCO,"11/17/2022 2 a.m. MST",4374,4468,4868,494
PSCO,"11/17/2022 3 a.m. MST",4412,4382,4821,409
PSCO,"11/17/2022 4 a.m. MST",4442,4408,4851,409
PSCO,"11/17/2022 5 a.m. MST",4549,4618,5042,493
PSCO,"11/17/2022 6 a.m. MST",4849,4749,5403,554
PSCO,"11/17/2022 7 a.m. MST",5257,5222,5805,548
PSCO,"11/17/2022 8 a.m. MST",5509,5427,6074,565
PSCO,"11/17/2022 9 a.m. MST",5631,5424,6045,414
PSCO,"11/17/2022 10 a.m. MST",5634,5406,5924,290
PSCO,"11/17/2022 11 a.m. MST",5593,5382,5887,294
PSCO,"11/17/2022 12 p.m. MST",5596,5345,5913,317
PSCO,"11/17/2022 1 p.m. MST",5590,5323,5766,176
PSCO,"11/17/2022 2 p.m. MST",5631,5327,5787,156
PSCO,"11/17/2022 3 p.m. MST",5649,5361,5787,138
PSCO,"11/17/2022 4 p.m. MST",5605,5442,5697,92
PSCO,"11/17/2022 5 p.m. MST",5834,5655,5988,154
PSCO,"11/17/2022 6 p.m. MST",6101,6025,6478,377
PSCO,"11/17/2022 7 p.m. MST",6025,5974,6556,531
PSCO,"11/17/2022 8 p.m. MST",5873,5856,6262,389
PSCO,"11/17/2022 9 p.m. MST",5647,5718,5989,342
PSCO,"11/17/2022 10 p.m. MST",5437,5459,5683,246
PSCO,"11/17/2022 11 p.m. MST",5130,5198,5350,220
PSCO,"11/18/2022 12 a.m. MST",4884,4865,5165,281
PSCO,"11/18/2022 1 a.m. MST",4779,4806,5130,351
PSCO,"11/18/2022 2 a.m. MST",4760,4740,5008,248
PSCO,"11/18/2022 3 a.m. MST",4731,4714,4993,262
PSCO,"11/18/2022 4 a.m. MST",4745,4771,5000,255
PSCO,"11/18/2022 5 a.m. MST",4845,4944,4706,-139
PSCO,"11/18/2022 6 a.m. MST",5097,5027,4704,-393
PSCO,"11/18/2022 7 a.m. MST",5373,5526,4745,-628
PSCO,"11/18/2022 8 a.m. MST",5591,5694,4997,-594
PSCO,"11/18/2022 9 a.m. MST",5628,5756,5122,-506
PSCO,"11/18/2022 10 a.m. MST",5585,5637,5131,-454
PSCO,"11/18/2022 11 a.m. MST",5550,5503,5227,-323
PSCO,"11/18/2022 12 p.m. MST",5490,5310,5370,-120
PSCO,"11/18/2022 1 p.m. MST",5424,5224,5403,-21
PSCO,"11/18/2022 2 p.m. MST",5347,5155,5300,-47
PSCO,"11/18/2022 3 p.m. MST",5275,5156,5287,12
PSCO,"11/18/2022 4 p.m. MST",5327,5262,5358,31
PSCO,"11/18/2022 5 p.m. MST",5595,5627,5528,-67
PSCO,"11/18/2022 6 p.m. MST",5898,5971,5942,44
PSCO,"11/18/2022 7 p.m. MST",5822,5908,6018,196
PSCO,"11/18/2022 8 p.m. MST",5698,5772,5722,24
PSCO,"11/18/2022 9 p.m. MST",5584,5624,5939,355
PSCO,"11/18/2022 10 p.m. MST",5444,5441,5885,441
PSCO,"11/18/2022 11 p.m. MST",5248,5239,5664,416
PSCO,"11/19/2022 12 a.m. MST",5045,5093,5718,673
PSCO,"11/19/2022 1 a.m. MST",4886,4861,5557,671
PSCO,"11/19/2022 2 a.m. MST",4786,4802,5205,419
PSCO,"11/19/2022 3 a.m. MST",4732,4787,5156,424
PSCO,"11/19/2022 4 a.m. MST",4744,4776,5149,405
PSCO,"11/19/2022 5 a.m. MST",4799,4847,5208,409
PSCO,"11/19/2022 6 a.m. MST",4937,4941,5360,423
PSCO,"11/19/2022 7 a.m. MST",5127,5183,5639,512
PSCO,"11/19/2022 8 a.m. MST",5236,5261,5588,352
PSCO,"11/19/2022 9 a.m. MST",5134,5152,5413,279
PSCO,"11/19/2022 10 a.m. MST",5084,5000,5257,173
PSCO,"11/19/2022 11 a.m. MST",4954,4888,5092,138
PSCO,"11/19/2022 12 p.m. MST",4846,4727,4997,151
PSCO,"11/19/2022 1 p.m. MST",4720,4636,4950,230
PSCO,"11/19/2022 2 p.m. MST",4647,4577,4787,140
PSCO,"11/19/2022 3 p.m. MST",4617,4556,4708,91
PSCO,"11/19/2022 4 p.m. MST",4779,4702,4747,-32
PSCO,"11/19/2022 5 p.m. MST",5088,5117,4940,-148
PSCO,"11/19/2022 6 p.m. MST",5441,5559,5230,-211
PSCO,"11/19/2022 7 p.m. MST",5410,5606,5322,-88
PSCO,"11/19/2022 8 p.m. MST",5377,5493,5512,135
PSCO,"11/19/2022 9 p.m. MST",5325,5399,5700,375
PSCO,"11/19/2022 10 p.m. MST",5177,5204,5713,536
PSCO,"11/19/2022 11 p.m. MST",5018,5071,5796,778
PSCO,"11/20/2022 12 a.m. MST",4829,4759,5608,779
PSCO,"11/20/2022 1 a.m. MST",4643,4656,5216,573
PSCO,"11/20/2022 2 a.m. MST",4575,4563,5156,581
PSCO,"11/20/2022 3 a.m. MST",4515,4588,4997,482
PSCO,"11/20/2022 4 a.m. MST",4472,4562,4982,510
PSCO,"11/20/2022 5 a.m. MST",4542,4585,5035,493
PSCO,"11/20/2022 6 a.m. MST",4630,4663,5183,553
PSCO,"11/20/2022 7 a.m. MST",4805,4855,5265,460
PSCO,"11/20/2022 8 a.m. MST",4833,4886,5283,450
PSCO,"11/20/2022 9 a.m. MST",4706,4724,5008,302
PSCO,"11/20/2022 10 a.m. MST",4636,4566,4802,166
PSCO,"11/20/2022 11 a.m. MST",4550,4466,4688,138
PSCO,"11/20/2022 12 p.m. MST",4497,4354,4625,128
PSCO,"11/20/2022 1 p.m. MST",4436,4314,4576,140
PSCO,"11/20/2022 2 p.m. MST",4365,4336,4538,173
PSCO,"11/20/2022 3 p.m. MST",4435,4395,4557,122
PSCO,"11/20/2022 4 p.m. MST",4634,4536,4675,41
PSCO,"11/20/2022 5 p.m. MST",4959,5003,4991,32
PSCO,"11/20/2022 6 p.m. MST",5301,5448,5220,-81
PSCO,"11/20/2022 7 p.m. MST",5307,5501,5194,-113
PSCO,"11/20/2022 8 p.m. MST",5213,5381,5135,-78
PSCO,"11/20/2022 9 p.m. MST",5122,5296,5256,134
PSCO,"11/20/2022 10 p.m. MST",4993,5109,5318,325
PSCO,"11/20/2022 11 p.m. MST",4719,4831,5119,400
PSCO,"11/21/2022 12 a.m. MST",4520,4630,4994,474
PSCO,"11/21/2022 1 a.m. MST",4394,4423,4757,363
PSCO,"11/21/2022 2 a.m. MST",4345,4321,4710,365
PSCO,"11/21/2022 3 a.m. MST",4341,4375,4715,374
PSCO,"11/21/2022 4 a.m. MST",4393,4346,4768,375
PSCO,"11/21/2022 5 a.m. MST",4532,4500,4953,421
PSCO,"11/21/2022 6 a.m. MST",4796,4656,5179,383
PSCO,"11/21/2022 7 a.m. MST",5156,5066,5346,190
PSCO,"11/21/2022 8 a.m. MST",5267,5232,5574,307
PSCO,"11/21/2022 9 a.m. MST",5084,5115,5342,258
PSCO,"11/21/2022 10 a.m. MST",4925,4932,5111,186
PSCO,"11/21/2022 11 a.m. MST",4836,4736,4862,26
PSCO,"11/21/2022 12 p.m. MST",4735,4582,4831,96
PSCO,"11/21/2022 1 p.m. MST",4677,4529,4784,107
PSCO,"11/21/2022 2 p.m. MST",4633,4521,4749,116
PSCO,"11/21/2022 3 p.m. MST",4704,4546,4826,122
PSCO,"11/21/2022 4 p.m. MST",4861,4712,4938,77
PSCO,"11/21/2022 5 p.m. MST",5218,5067,5359,141
PSCO,"11/21/2022 6 p.m. MST",5563,5595,5642,79
PSCO,"11/21/2022 7 p.m. MST",5499,5577,5613,114
PSCO,"11/21/2022 8 p.m. MST",5407,5476,5559,152
PSCO,"11/21/2022 9 p.m. MST",5331,5356,5450,119
PSCO,"11/21/2022 10 p.m. MST",5090,5207,5416,326
PSCO,"11/21/2022 11 p.m. MST",4829,4989,5210,381
PSCO,"11/22/2022 12 a.m. MST",4615,4721,5021,406
PSCO,"11/22/2022 1 a.m. MST",4437,4309,4944,507
PSCO,"11/22/2022 2 a.m. MST",4365,4218,4945,580
PSCO,"11/22/2022 3 a.m. MST",4293,4405,4884,591
PSCO,"11/22/2022 4 a.m. MST",4341,4408,5001,660
PSCO,"11/22/2022 5 a.m. MST",4456,4607,5350,894
PSCO,"11/22/2022 6 a.m. MST",4772,4784,5666,894
PSCO,"11/22/2022 7 a.m. MST",5190,5161,6069,879
PSCO,"11/22/2022 8 a.m. MST",5337,5311,6185,848
PSCO,"11/22/2022 9 a.m. MST",5142,5072,5881,739
PSCO,"11/22/2022 10 a.m. MST",4980,4947,5585,605
PSCO,"11/22/2022 11 a.m. MST",4763,4757,5250,487
PSCO,"11/22/2022 12 p.m. MST",4775,4589,5213,438
PSCO,"11/22/2022 1 p.m. MST",4721,4510,4957,236
PSCO,"11/22/2022 2 p.m. MST",4634,4516,4824,190
PSCO,"11/22/2022 3 p.m. MST",4696,4568,4892,196
PSCO,"11/22/2022 4 p.m. MST",4891,4689,5059,168
PSCO,"11/22/2022 5 p.m. MST",5221,5073,5360,139
PSCO,"11/22/2022 6 p.m. MST",5464,5518,5555,91
PSCO,"11/22/2022 7 p.m. MST",5444,5434,5514,70
PSCO,"11/22/2022 8 p.m. MST",5349,5382,5504,155
PSCO,"11/22/2022 9 p.m. MST",5257,5285,5390,133
PSCO,"11/22/2022 10 p.m. MST",5059,5095,5258,199
PSCO,"11/22/2022 11 p.m. MST",4770,4816,4951,181
PSCO,"11/23/2022 12 a.m. MST",4577,4646,4769,192
PSCO,"11/23/2022 1 a.m. MST",4434,4529,4725,291
PSCO,"11/23/2022 2 a.m. MST",4352,4429,4617,265
PSCO,"11/23/2022 3 a.m. MST",4344,4442,4575,231
PSCO,"11/23/2022 4 a.m. MST",4382,4461,4673,291
PSCO,"11/23/2022 5 a.m. MST",4536,4596,4743,207
PSCO,"11/23/2022 6 a.m. MST",4792,4782,4887,95
PSCO,"11/23/2022 7 a.m. MST",5041,5148,5089,48
PSCO,"11/23/2022 8 a.m. MST",5079,5334,5173,94
PSCO,"11/23/2022 9 a.m. MST",5029,5171,5246,217
PSCO,"11/23/2022 10 a.m. MST",4904,4974,5202,298
PSCO,"11/23/2022 11 a.m. MST",4945,4902,5106,161
PSCO,"11/23/2022 12 p.m. MST",5003,4755,5323,320
PSCO,"11/23/2022 1 p.m. MST",4985,4612,5290,305
PSCO,"11/23/2022 2 p.m. MST",4961,4614,5204,243
PSCO,"11/23/2022 3 p.m. MST",4874,4871,5182,308
PSCO,"11/23/2022 4 p.m. MST",5044,5095,5360,316
PSCO,"11/23/2022 5 p.m. MST",5358,5378,5685,327
PSCO,"11/23/2022 6 p.m. MST",5619,5657,5842,223
PSCO,"11/23/2022 7 p.m. MST",5551,5544,5810,259
PSCO,"11/23/2022 8 p.m. MST",5453,5411,5638,185
PSCO,"11/23/2022 9 p.m. MST",5339,5339,5437,98
PSCO,"11/23/2022 10 p.m. MST",5145,5157,5343,198
PSCO,"11/23/2022 11 p.m. MST",4889,4922,5185,296
PSCO,"11/24/2022 12 a.m. MST",4649,4681,5044,395
PSCO,"11/24/2022 1 a.m. MST",4472,4509,4969,497
PSCO,"11/24/2022 2 a.m. MST",4340,4400,4938,598
PSCO,"11/24/2022 3 a.m. MST",4310,4365,4844,534
PSCO,"11/24/2022 4 a.m. MST",4321,4372,4793,472
PSCO,"11/24/2022 5 a.m. MST",4386,4412,4841,455
PSCO,"11/24/2022 6 a.m. MST",4486,4526,4815,329
PSCO,"11/24/2022 7 a.m. MST",4724,4751,5105,381
PSCO,"11/24/2022 8 a.m. MST",4847,4860,5160,313
PSCO,"11/24/2022 9 a.m. MST",4966,5001,5173,207
PSCO,"11/24/2022 10 a.m. MST",5091,5110,5305,214
PSCO,"11/24/2022 11 a.m. MST",5135,5091,5348,213
PSCO,"11/24/2022 12 p.m. MST",5056,5099,5262,206
PSCO,"11/24/2022 1 p.m. MST",4863,5056,5051,188
PSCO,"11/24/2022 2 p.m. MST",4703,5066,4807,104
PSCO,"11/24/2022 3 p.m. MST",4621,4971,4736,115
PSCO,"11/24/2022 4 p.m. MST",4679,4949,4769,90
PSCO,"11/24/2022 5 p.m. MST",4913,4927,5034,121
PSCO,"11/24/2022 6 p.m. MST",5009,5093,5221,212
PSCO,"11/24/2022 7 p.m. MST",4932,5077,5128,196
PSCO,"11/24/2022 8 p.m. MST",4892,5026,5116,224
PSCO,"11/24/2022 9 p.m. MST",4881,4956,4958,77
PSCO,"11/24/2022 10 p.m. MST",4777,4896,4984,207
PSCO,"11/24/2022 11 p.m. MST",4659,4716,4871,212
PSCO,"11/25/2022 12 a.m. MST",4537,4643,4717,180
PSCO,"11/25/2022 1 a.m. MST",4416,4554,4580,164
PSCO,"11/25/2022 2 a.m. MST",4357,4388,4658,301
PSCO,"11/25/2022 3 a.m. MST",4315,4387,4594,279
PSCO,"11/25/2022 4 a.m. MST",4391,4432,4654,263
PSCO,"11/25/2022 5 a.m. MST",4462,4539,4759,297
PSCO,"11/25/2022 6 a.m. MST",4587,4666,4800,213
PSCO,"11/25/2022 7 a.m. MST",4796,4890,5002,206
PSCO,"11/25/2022 8 a.m. MST",4804,4976,5093,289
PSCO,"11/25/2022 9 a.m. MST",4599,4716,4746,147
PSCO,"11/25/2022 10 a.m. MST",4399,4591,4628,229
PSCO,"11/25/2022 11 a.m. MST",4350,4472,4586,236
PSCO,"11/25/2022 12 p.m. MST",4275,4355,4371,96
PSCO,"11/25/2022 1 p.m. MST",4189,4287,4269,80
PSCO,"11/25/2022 2 p.m. MST",4204,4206,4232,28
PSCO,"11/25/2022 3 p.m. MST",4250,4346,4270,20
PSCO,"11/25/2022 4 p.m. MST",4428,4448,4451,23
PSCO,"11/25/2022 5 p.m. MST",4769,4841,4765,-4
PSCO,"11/25/2022 6 p.m. MST",5054,5251,5119,65
PSCO,"11/25/2022 7 p.m. MST",4930,5151,5040,110
PSCO,"11/25/2022 8 p.m. MST",4936,5040,5032,96
PSCO,"11/25/2022 9 p.m. MST",4882,5009,4975,93
PSCO,"11/25/2022 10 p.m. MST",4774,4856,4848,74
PSCO,"11/25/2022 11 p.m. MST",4535,4647,4658,123
PSCO,"11/26/2022 12 a.m. MST",4367,4518,4514,147
PSCO,"11/26/2022 1 a.m. MST",4220,4287,4478,258
PSCO,"11/26/2022 2 a.m. MST",4182,4213,4552,370
PSCO,"11/26/2022 3 a.m. MST",4179,4233,4773,594
PSCO,"11/26/2022 4 a.m. MST",4188,4282,4679,491
PSCO,"11/26/2022 5 a.m. MST",4229,4339,4649,420
PSCO,"11/26/2022 6 a.m. MST",4350,4492,4770,420
PSCO,"11/26/2022 7 a.m. MST",4587,4732,5053,466
PSCO,"11/26/2022 8 a.m. MST",4612,4763,5165,553
PSCO,"11/26/2022 9 a.m. MST",4476,4622,4844,368
PSCO,"11/26/2022 10 a.m. MST",4359,4443,4713,354
PSCO,"11/26/2022 11 a.m. MST",4289,4308,4717,428
PSCO,"11/26/2022 12 p.m. MST",4265,4245,4686,421
PSCO,"11/26/2022 1 p.m. MST",4225,4257,4610,385
PSCO,"11/26/2022 2 p.m. MST",4221,4204,4541,320
PSCO,"11/26/2022 3 p.m. MST",4257,4225,4576,319
PSCO,"11/26/2022 4 p.m. MST",4488,4350,4814,326
PSCO,"11/26/2022 5 p.m. MST",4803,4710,5241,438
PSCO,"11/26/2022 6 p.m. MST",5127,5160,5587,460
PSCO,"11/26/2022 7 p.m. MST",5080,5110,5491,411
PSCO,"11/26/2022 8 p.m. MST",4992,5070,5375,383
PSCO,"11/26/2022 9 p.m. MST",4918,5040,5256,338
PSCO,"11/26/2022 10 p.m. MST",4782,4943,5068,286
PSCO,"11/26/2022 11 p.m. MST",4567,4700,4865,298
PSCO,"11/27/2022 12 a.m. MST",4353,4368,4652,299
PSCO,"11/27/2022 1 a.m. MST",4201,4239,4434,233
PSCO,"11/27/2022 2 a.m. MST",4115,4133,4299,184
PSCO,"11/27/2022 3 a.m. MST",4040,4239,4180,140
PSCO,"11/27/2022 4 a.m. MST",3987,4275,4216,229
PSCO,"11/27/2022 5 a.m. MST",4014,4252,4110,96
PSCO,"11/27/2022 6 a.m. MST",4148,4368,4240,92
PSCO,"11/27/2022 7 a.m. MST",4327,4543,4357,30
PSCO,"11/27/2022 8 a.m. MST",4465,4636,4614,149
PSCO,"11/27/2022 9 a.m. MST",4398,4517,4427,29
PSCO,"11/27/2022 10 a.m. MST",4378,4470,4479,101
PSCO,"11/27/2022 11 a.m. MST",4268,4372,4452,184
PSCO,"11/27/2022 12 p.m. MST",4298,4255,4604,306
PSCO,"11/27/2022 1 p.m. MST",4351,4260,4498,147
PSCO,"11/27/2022 2 p.m. MST",4397,4319,4496,99
PSCO,"11/27/2022 3 p.m. MST",4628,4351,4622,-6
PSCO,"11/27/2022 4 p.m. MST",4669,4410,4768,99
PSCO,"11/27/2022 5 p.m. MST",5009,4900,5194,185
PSCO,"11/27/2022 6 p.m. MST",5419,5317,5729,310
PSCO,"11/27/2022 7 p.m. MST",5401,5363,5670,269
PSCO,"11/27/2022 8 p.m. MST",5296,5264,5634,338
PSCO,"11/27/2022 9 p.m. MST",5185,5109,5457,272
PSCO,"11/27/2022 10 p.m. MST",4965,4927,5180,215
PSCO,"11/27/2022 11 p.m. MST",4652,4681,4839,187
PSCO,"11/28/2022 12 a.m. MST",4365,4519,4549,184
PSCO,"11/28/2022 1 a.m. MST",4233,4367,4271,38
PSCO,"11/28/2022 2 a.m. MST",4164,4317,4242,78
PSCO,"11/28/2022 3 a.m. MST",4144,4322,4204,60
PSCO,"11/28/2022 4 a.m. MST",4180,4364,4298,118
PSCO,"11/28/2022 5 a.m. MST",4303,4442,4494,191
PSCO,"11/28/2022 6 a.m. MST",4597,4665,4903,306
PSCO,"11/28/2022 7 a.m. MST",4983,5122,5263,280
PSCO,"11/28/2022 8 a.m. MST",5139,5296,5584,445
PSCO,"11/28/2022 9 a.m. MST",5011,5029,5446,435
PSCO,"11/28/2022 10 a.m. MST",4843,4861,5178,335
PSCO,"11/28/2022 11 a.m. MST",4765,4732,4970,205
PSCO,"11/28/2022 12 p.m. MST",4744,4610,4996,252
PSCO,"11/28/2022 1 p.m. MST",4762,4532,5023,261
PSCO,"11/28/2022 2 p.m. MST",4857,4505,5121,264
PSCO,"11/28/2022 3 p.m. MST",4928,4631,5307,379
PSCO,"11/28/2022 4 p.m. MST",5064,4860,5307,243
PSCO,"11/28/2022 5 p.m. MST",5352,5314,5535,183
PSCO,"11/28/2022 6 p.m. MST",5678,5615,5872,194
PSCO,"11/28/2022 7 p.m. MST",5623,5529,5955,332
PSCO,"11/28/2022 8 p.m. MST",5486,5433,5935,449
PSCO,"11/28/2022 9 p.m. MST",5383,5315,5652,269
PSCO,"11/28/2022 10 p.m. MST",5203,5093,5512,309
PSCO,"11/28/2022 11 p.m. MST",4950,4770,5255,305
PSCO,"11/29/2022 12 a.m. MST",4698,4559,4980,282
PSCO,"11/29/2022 1 a.m. MST",4570,4431,4938,368
PSCO,"11/29/2022 2 a.m. MST",4511,4361,4843,332
PSCO,"11/29/2022 3 a.m. MST",4515,4320,4877,362
PSCO,"11/29/2022 4 a.m. MST",4591,4407,4845,254
PSCO,"11/29/2022 5 a.m. MST",4676,4570,4967,291
PSCO,"11/29/2022 6 a.m. MST",4933,4837,5211,278
PSCO,"11/29/2022 7 a.m. MST",5353,5316,5589,236
PSCO,"11/29/2022 8 a.m. MST",5511,5481,5805,294
PSCO,"11/29/2022 9 a.m. MST",5652,5462,6125,473
PSCO,"11/29/2022 10 a.m. MST",5728,5548,6123,395
PSCO,"11/29/2022 11 a.m. MST",5768,5508,6065,297
PSCO,"11/29/2022 12 p.m. MST",5670,5495,6158,488
PSCO,"11/29/2022 1 p.m. MST",5620,5428,5920,300
PSCO,"11/29/2022 2 p.m. MST",5602,5415,5726,124
PSCO,"11/29/2022 3 p.m. MST",5535,5432,5426,-109
PSCO,"11/29/2022 4 p.m. MST",5535,5549,5322,-213
PSCO,"11/29/2022 5 p.m. MST",5873,5847,5627,-246
PSCO,"11/29/2022 6 p.m. MST",6240,6163,5898,-342
PSCO,"11/29/2022 7 p.m. MST",6108,6052,5950,-158
PSCO,"11/29/2022 8 p.m. MST",5976,5947,5877,-99
PSCO,"11/29/2022 9 p.m. MST",5807,5857,5485,-322
PSCO,"11/29/2022 10 p.m. MST",5538,5577,5394,-144
PSCO,"11/29/2022 11 p.m. MST",5206,5237,5472,266
PSCO,"11/30/2022 12 a.m. MST",5014,5037,5352,338
PSCO,"11/30/2022 1 a.m. MST",4892,4851,5417,525
PSCO,"11/30/2022 2 a.m. MST",4831,4797,5502,671
PSCO,"11/30/2022 3 a.m. MST",4787,4799,5437,650
PSCO,"11/30/2022 4 a.m. MST",4821,4863,5440,619
PSCO,"11/30/2022 5 a.m. MST",4948,4969,5577,629
PSCO,"11/30/2022 6 a.m. MST",5217,5203,5816,599
PSCO,"11/30/2022 7 a.m. MST",5660,5711,6290,630
PSCO,"11/30/2022 8 a.m. MST",5803,5882,6567,764
PSCO,"11/30/2022 9 a.m. MST",5705,5693,6434,729
PSCO,"11/30/2022 10 a.m. MST",5579,5362,6079,500
PSCO,"11/30/2022 11 a.m. MST",5534,5238,5898,364
PSCO,"11/30/2022 12 p.m. MST",5402,5028,5735,333
PSCO,"11/30/2022 1 p.m. MST",5232,4927,5494,262
PSCO,"11/30/2022 2 p.m. MST",5131,4896,5356,225
PSCO,"11/30/2022 3 p.m. MST",5104,4968,5320,216
PSCO,"11/30/2022 4 p.m. MST",5224,5022,5442,218
PSCO,"11/30/2022 5 p.m. MST",5650,5488,5926,276
PSCO,"11/30/2022 6 p.m. MST",6029,5983,6513,484
PSCO,"11/30/2022 7 p.m. MST",5968,5972,6476,508
PSCO,"11/30/2022 8 p.m. MST",5837,5831,6281,444
PSCO,"11/30/2022 9 p.m. MST",5728,5689,6185,457
PSCO,"11/30/2022 10 p.m. MST",5476,5454,5988,512
PSCO,"11/30/2022 11 p.m. MST",5146,5104,5672,526
PSCO,"12/1/2022 12 a.m. MST",4981,4887,5353,372
