"BA Code","Timestamp (Hour Ending)","Demand (MWh)","Demand Forecast (MWh)","Net Generation (MWh)","Total Interchange (MWh)"
PSCO,"10/1/2022 12 a.m. MDT",3981,3999,4072,91
PSCO,"10/1/2022 1 a.m. MDT",3770,3717,3792,22
PSCO,"10/1/2022 2 a.m. MDT",3660,3575,3560,-100
PSCO,"10/1/2022 3 a.m. MDT",3559,3481,3401,-158
PSCO,"10/1/2022 4 a.m. MDT",3516,3547,3373,-143
PSCO,"10/1/2022 5 a.m. MDT",3480,3558,3152,-328
PSCO,"10/1/2022 6 a.m. MDT",3588,3660,3231,-357
PSCO,"10/1/2022 7 a.m. MDT",3693,3843,3364,-329
PSCO,"10/1/2022 8 a.m. MDT",3788,3872,3351,-437
PSCO,"10/1/2022 9 a.m. MDT",3828,3913,3404,-424
PSCO,"10/1/2022 10 a.m. MDT",3886,3944,3278,-608
PSCO,"10/1/2022 11 a.m. MDT",3927,3943,3284,-643
PSCO,"10/1/2022 12 p.m. MDT",3876,4012,3234,-642
PSCO,"10/1/2022 1 p.m. MDT",4052,4127,3332,-720
PSCO,"10/1/2022 2 p.m. MDT",4211,4203,3632,-579
PSCO,"10/1/2022 3 p.m. MDT",4371,4266,3958,-413
PSCO,"10/1/2022 4 p.m. MDT",4492,4344,4289,-203
PSCO,"10/1/2022 5 p.m. MDT",4541,4475,4281,-260
PSCO,"10/1/2022 6 p.m. MDT",4573,4552,4209,-364
PSCO,"10/1/2022 7 p.m. MDT",4576,4603,4296,-280
PSCO,"10/1/2022 8 p.m. MDT",4659,4640,4259,-400
PSCO,"10/1/2022 9 p.m. MDT",4503,4501,4089,-414
PSCO,"10/1/2022 10 p.m. MDT",4330,4368,3945,-385
PSCO,"10/1/2022 11 p.m. MDT",4100,4144,3609,-491
PSCO,"10/2/2022 12 a.m. MDT",3839,3952,3650,-189
PSCO,"10/2/2022 1 a.m. MDT",3630,3768,3698,68
PSCO,"10/2/2022 2 a.m. MDT",3530,3672,3352,-178
PSCO,"10/2/2022 3 a.m. MDT",3470,3540,3295,-175
PSCO,"10/2/2022 4 a.m. MDT",3439,3482,3291,-148
PSCO,"10/2/2022 5 a.m. MDT",3426,3495,3460,34
PSCO,"10/2/2022 6 a.m. MDT",3473,3534,3545,72
PSCO,"10/2/2022 7 a.m. MDT",3632,3720,3676,44
PSCO,"10/2/2022 8 a.m. MDT",3720,3737,3799,79
PSCO,"10/2/2022 9 a.m. MDT",3833,3792,3913,80
PSCO,"10/2/2022 10 a.m. MDT",3965,3840,3999,34
PSCO,"10/2/2022 11 a.m. MDT",4046,3926,3935,-111
PSCO,"10/2/2022 12 p.m. MDT",4039,3986,3983,-56
PSCO,"10/2/2022 1 p.m. MDT",4019,4067,4017,-2
PSCO,"10/2/2022 2 p.m. MDT",3956,4144,4016,60
PSCO,"10/2/2022 3 p.m. MDT",4030,4256,4135,105
PSCO,"10/2/2022 4 p.m. MDT",4219,4310,4436,217
PSCO,"10/2/2022 5 p.m. MDT",4448,4450,4568,120
PSCO,"10/2/2022 6 p.m. MDT",4700,4539,4543,-157
PSCO,"10/2/2022 7 p.m. MDT",4780,4757,4600,-180
PSCO,"10/2/2022 8 p.m. MDT",4769,4757,4391,-378
PSCO,"10/2/2022 9 p.m. MDT",4574,4626,4285,-289
PSCO,"10/2/2022 10 p.m. MDT",4381,4310,4225,-156
PSCO,"10/2/2022 11 p.m. MDT",4104,4023,3968,-136
PSCO,"10/3/2022 12 a.m. MDT",3852,3810,3711,-141
PSCO,"10/3/2022 1 a.m. MDT",3645,3651,3464,-181
PSCO,"10/3/2022 2 a.m. MDT",3538,3577,3412,-126
PSCO,"10/3/2022 3 a.m. MDT",3481,3444,3334,-147
PSCO,"10/3/2022 4 a.m. MDT",3469,3429,3319,-150
PSCO,"10/3/2022 5 a.m. MDT",3496,3538,3267,-229
PSCO,"10/3/2022 6 a.m. MDT",3636,3741,3440,-196
PSCO,"10/3/2022 7 a.m. MDT",4020,4141,3753,-267
PSCO,"10/3/2022 8 a.m. MDT",4269,4266,4144,-125
PSCO,"10/3/2022 9 a.m. MDT",4327,4327,4180,-147
PSCO,"10/3/2022 10 a.m. MDT",4374,4366,4065,-309
PSCO,"10/3/2022 11 a.m. MDT",4400,4374,3949,-451
PSCO,"10/3/2022 12 p.m. MDT",4369,4422,3814,-555
PSCO,"10/3/2022 1 p.m. MDT",4428,4498,3702,-726
PSCO,"10/3/2022 2 p.m. MDT",4500,4636,3695,-805
PSCO,"10/3/2022 3 p.m. MDT",4664,4701,3787,-877
PSCO,"10/3/2022 4 p.m. MDT",4758,4742,3892,-866
PSCO,"10/3/2022 5 p.m. MDT",4816,4875,3844,-972
PSCO,"10/3/2022 6 p.m. MDT",4984,4848,3968,-1016
PSCO,"10/3/2022 7 p.m. MDT",4955,4933,3939,-1016
PSCO,"10/3/2022 8 p.m. MDT",4908,4942,4077,-831
PSCO,"10/3/2022 9 p.m. MDT",4678,4748,4057,-621
PSCO,"10/3/2022 10 p.m. MDT",4435,4490,4115,-320
PSCO,"10/3/2022 11 p.m. MDT",4127,4149,3800,-327
PSCO,"10/4/2022 12 a.m. MDT",3851,3890,3543,-308
PSCO,"10/4/2022 1 a.m. MDT",3683,3717,3480,-203
PSCO,"10/4/2022 2 a.m. MDT",3589,3594,3278,-311
PSCO,"10/4/2022 3 a.m. MDT",3414,3538,3124,-290
PSCO,"10/4/2022 4 a.m. MDT",3432,3482,3056,-376
PSCO,"10/4/2022 5 a.m. MDT",3528,3583,3194,-334
PSCO,"10/4/2022 6 a.m. MDT",3748,3796,3413,-335
PSCO,"10/4/2022 7 a.m. MDT",4156,4202,3801,-355
PSCO,"10/4/2022 8 a.m. MDT",4336,4340,4018,-318
PSCO,"10/4/2022 9 a.m. MDT",4272,4397,3984,-288
PSCO,"10/4/2022 10 a.m. MDT",4218,4451,3860,-358
PSCO,"10/4/2022 11 a.m. MDT",4201,4518,3608,-593
PSCO,"10/4/2022 12 p.m. MDT",4149,4504,3480,-669
PSCO,"10/4/2022 1 p.m. MDT",4222,4470,3425,-797
PSCO,"10/4/2022 2 p.m. MDT",4283,4436,3545,-738
PSCO,"10/4/2022 3 p.m. MDT",4405,4452,3655,-750
PSCO,"10/4/2022 4 p.m. MDT",4477,4570,3746,-731
PSCO,"10/4/2022 5 p.m. MDT",4637,4809,3884,-753
PSCO,"10/4/2022 6 p.m. MDT",4819,4886,4175,-644
PSCO,"10/4/2022 7 p.m. MDT",4888,4895,4228,-660
PSCO,"10/4/2022 8 p.m. MDT",4843,4997,4211,-632
PSCO,"10/4/2022 9 p.m. MDT",4712,4814,4044,-668
PSCO,"10/4/2022 10 p.m. MDT",4409,4541,3735,-674
PSCO,"10/4/2022 11 p.m. MDT",4117,4188,3685,-432
PSCO,"10/5/2022 12 a.m. MDT",3860,3909,3564,-296
PSCO,"10/5/2022 1 a.m. MDT",3650,3725,3384,-266
PSCO,"10/5/2022 2 a.m. MDT",3527,3587,3352,-175
PSCO,"10/5/2022 3 a.m. MDT",3465,3529,3357,-108
PSCO,"10/5/2022 4 a.m. MDT",3455,3483,3259,-196
PSCO,"10/5/2022 5 a.m. MDT",3531,3581,3303,-228
PSCO,"10/5/2022 6 a.m. MDT",3679,3786,3249,-430
PSCO,"10/5/2022 7 a.m. MDT",4049,4190,3575,-474
PSCO,"10/5/2022 8 a.m. MDT",4252,4357,3860,-392
PSCO,"10/5/2022 9 a.m. MDT",4225,4377,3912,-313
PSCO,"10/5/2022 10 a.m. MDT",4153,4343,3803,-350
PSCO,"10/5/2022 11 a.m. MDT",4137,4283,3758,-379
PSCO,"10/5/2022 12 p.m. MDT",4155,4299,3771,-384
PSCO,"10/5/2022 1 p.m. MDT",4197,4299,3810,-387
PSCO,"10/5/2022 2 p.m. MDT",4252,4402,3871,-381
PSCO,"10/5/2022 3 p.m. MDT",4323,4482,3958,-365
PSCO,"10/5/2022 4 p.m. MDT",4448,4609,4040,-408
PSCO,"10/5/2022 5 p.m. MDT",4622,4849,4087,-535
PSCO,"10/5/2022 6 p.m. MDT",4788,4941,4220,-568
PSCO,"10/5/2022 7 p.m. MDT",4857,4925,4259,-598
PSCO,"10/5/2022 8 p.m. MDT",4846,4919,4310,-536
PSCO,"10/5/2022 9 p.m. MDT",4653,4783,4244,-409
PSCO,"10/5/2022 10 p.m. MDT",4376,4513,4050,-326
PSCO,"10/5/2022 11 p.m. MDT",4026,4171,3731,-295
PSCO,"10/6/2022 12 a.m. MDT",3734,3902,3410,-324
PSCO,"10/6/2022 1 a.m. MDT",3571,3722,3432,-139
PSCO,"10/6/2022 2 a.m. MDT",3510,3613,3341,-169
PSCO,"10/6/2022 3 a.m. MDT",3426,3521,3221,-205
PSCO,"10/6/2022 4 a.m. MDT",3474,3472,3239,-235
PSCO,"10/6/2022 5 a.m. MDT",3511,3530,3265,-246
PSCO,"10/6/2022 6 a.m. MDT",3717,3771,3372,-345
PSCO,"10/6/2022 7 a.m. MDT",4086,4182,3697,-389
PSCO,"10/6/2022 8 a.m. MDT",4265,4367,3985,-280
PSCO,"10/6/2022 9 a.m. MDT",4188,4316,3905,-283
PSCO,"10/6/2022 10 a.m. MDT",4104,4270,3773,-331
PSCO,"10/6/2022 11 a.m. MDT",4072,4209,3704,-368
PSCO,"10/6/2022 12 p.m. MDT",4095,4230,3769,-326
PSCO,"10/6/2022 1 p.m. MDT",4122,4235,3803,-319
PSCO,"10/6/2022 2 p.m. MDT",4238,4365,3917,-321
PSCO,"10/6/2022 3 p.m. MDT",4321,4459,4017,-304
PSCO,"10/6/2022 4 p.m. MDT",4482,4586,4146,-336
PSCO,"10/6/2022 5 p.m. MDT",4677,4820,4309,-368
PSCO,"10/6/2022 6 p.m. MDT",4831,4951,4423,-408
PSCO,"10/6/2022 7 p.m. MDT",4836,4949,4508,-328
PSCO,"10/6/2022 8 p.m. MDT",4883,4998,4718,-165
PSCO,"10/6/2022 9 p.m. MDT",4750,4821,4685,-65
PSCO,"10/6/2022 10 p.m. MDT",4507,4530,4487,-20
PSCO,"10/6/2022 11 p.m. MDT",4195,4199,4184,-11
PSCO,"10/7/2022 12 a.m. MDT",3851,3907,3755,-96
PSCO,"10/7/2022 1 a.m. MDT",3587,3746,3645,58
PSCO,"10/7/2022 2 a.m. MDT",3403,3596,3610,207
PSCO,"10/7/2022 3 a.m. MDT",3353,3552,3567,214
PSCO,"10/7/2022 4 a.m. MDT",3357,3503,3412,55
PSCO,"10/7/2022 5 a.m. MDT",3487,3555,3520,33
PSCO,"10/7/2022 6 a.m. MDT",3686,3782,3509,-177
PSCO,"10/7/2022 7 a.m. MDT",3971,4196,3727,-244
PSCO,"10/7/2022 8 a.m. MDT",4271,4356,4106,-165
PSCO,"10/7/2022 9 a.m. MDT",4478,4377,4304,-174
PSCO,"10/7/2022 10 a.m. MDT",4454,4383,4363,-91
PSCO,"10/7/2022 11 a.m. MDT",4508,4285,4385,-123
PSCO,"10/7/2022 12 p.m. MDT",4420,4293,4237,-183
PSCO,"10/7/2022 1 p.m. MDT",4374,4284,4155,-219
PSCO,"10/7/2022 2 p.m. MDT",4387,4357,4142,-245
PSCO,"10/7/2022 3 p.m. MDT",4360,4366,4097,-263
PSCO,"10/7/2022 4 p.m. MDT",4363,4360,4130,-233
PSCO,"10/7/2022 5 p.m. MDT",4450,4515,3969,-481
PSCO,"10/7/2022 6 p.m. MDT",4483,4548,3996,-487
PSCO,"10/7/2022 7 p.m. MDT",4597,4704,4006,-591
PSCO,"10/7/2022 8 p.m. MDT",4609,4773,4061,-548
PSCO,"10/7/2022 9 p.m. MDT",4459,4592,3967,-492
PSCO,"10/7/2022 10 p.m. MDT",4265,4407,3843,-422
PSCO,"10/7/2022 11 p.m. MDT",4036,4157,3707,-329
PSCO,"10/8/2022 12 a.m. MDT",3790,3918,3474,-316
PSCO,"10/8/2022 1 a.m. MDT",3620,3796,3418,-202
PSCO,"10/8/2022 2 a.m. MDT",3513,3693,3385,-128
PSCO,"10/8/2022 3 a.m. MDT",3459,3611,3275,-184
PSCO,"10/8/2022 4 a.m. MDT",3408,3644,3264,-144
PSCO,"10/8/2022 5 a.m. MDT",3449,3663,3300,-149
PSCO,"10/8/2022 6 a.m. MDT",3557,3773,3371,-186
PSCO,"10/8/2022 7 a.m. MDT",3674,3946,3464,-210
PSCO,"10/8/2022 8 a.m. MDT",3869,4024,3635,-234
PSCO,"10/8/2022 9 a.m. MDT",3948,4043,3772,-176
PSCO,"10/8/2022 10 a.m. MDT",3844,3936,3721,-123
PSCO,"10/8/2022 11 a.m. MDT",3723,3939,3584,-139
PSCO,"10/8/2022 12 p.m. MDT",3637,3937,3553,-84
PSCO,"10/8/2022 1 p.m. MDT",3634,3911,3541,-93
PSCO,"10/8/2022 2 p.m. MDT",3638,3841,3513,-125
PSCO,"10/8/2022 3 p.m. MDT",3650,3869,3504,-146
PSCO,"10/8/2022 4 p.m. MDT",3742,4048,3570,-172
PSCO,"10/8/2022 5 p.m. MDT",3993,4131,3776,-217
PSCO,"10/8/2022 6 p.m. MDT",4221,4301,4014,-207
PSCO,"10/8/2022 7 p.m. MDT",4382,4437,4038,-344
PSCO,"10/8/2022 8 p.m. MDT",4403,4604,4041,-362
PSCO,"10/8/2022 9 p.m. MDT",4273,4447,3983,-290
PSCO,"10/8/2022 10 p.m. MDT",4097,4251,3869,-228
PSCO,"10/8/2022 11 p.m. MDT",3869,4009,3619,-250
PSCO,"10/9/2022 12 a.m. MDT",3669,3852,3435,-234
PSCO,"10/9/2022 1 a.m. MDT",3517,3802,3362,-155
PSCO,"10/9/2022 2 a.m. MDT",3400,3695,3312,-88
PSCO,"10/9/2022 3 a.m. MDT",3336,3604,3249,-87
PSCO,"10/9/2022 4 a.m. MDT",3328,3558,3208,-120
PSCO,"10/9/2022 5 a.m. MDT",3350,3567,3186,-164
PSCO,"10/9/2022 6 a.m. MDT",3465,3628,3268,-197
PSCO,"10/9/2022 7 a.m. MDT",3615,3842,3447,-168
PSCO,"10/9/2022 8 a.m. MDT",3705,3859,3559,-146
PSCO,"10/9/2022 9 a.m. MDT",3647,3880,3603,-44
PSCO,"10/9/2022 10 a.m. MDT",3638,3921,3574,-64
PSCO,"10/9/2022 11 a.m. MDT",3646,3975,3594,-52
PSCO,"10/9/2022 12 p.m. MDT",3630,4044,3691,61
PSCO,"10/9/2022 1 p.m. MDT",3680,4083,3726,46
PSCO,"10/9/2022 2 p.m. MDT",3735,4026,3717,-18
PSCO,"10/9/2022 3 p.m. MDT",3833,4170,3795,-38
PSCO,"10/9/2022 4 p.m. MDT",3982,4314,3896,-86
PSCO,"10/9/2022 5 p.m. MDT",4230,4360,3997,-233
PSCO,"10/9/2022 6 p.m. MDT",4471,4594,4301,-170
PSCO,"10/9/2022 7 p.m. MDT",4623,4882,4439,-184
PSCO,"10/9/2022 8 p.m. MDT",4623,5025,4438,-185
PSCO,"10/9/2022 9 p.m. MDT",4458,4780,4227,-231
PSCO,"10/9/2022 10 p.m. MDT",4213,4526,4073,-140
PSCO,"10/9/2022 11 p.m. MDT",3992,4292,4015,23
PSCO,"10/10/2022 12 a.m. MDT",3732,3941,3792,60
PSCO,"10/10/2022 1 a.m. MDT",3555,3641,3711,156
PSCO,"10/10/2022 2 a.m. MDT",3486,3619,3719,233
PSCO,"10/10/2022 3 a.m. MDT",3392,3571,3656,264
PSCO,"10/10/2022 4 a.m. MDT",3429,3551,3622,193
PSCO,"10/10/2022 5 a.m. MDT",3492,3688,3685,193
PSCO,"10/10/2022 6 a.m. MDT",3697,3889,3746,49
PSCO,"10/10/2022 7 a.m. MDT",4094,4230,4035,-59
PSCO,"10/10/2022 8 a.m. MDT",4312,4377,4246,-66
PSCO,"10/10/2022 9 a.m. MDT",4236,4302,4034,-202
PSCO,"10/10/2022 10 a.m. MDT",4176,4235,4046,-130
PSCO,"10/10/2022 11 a.m. MDT",4109,4188,4183,74
PSCO,"10/10/2022 12 p.m. MDT",4167,4152,4263,96
PSCO,"10/10/2022 1 p.m. MDT",4248,4195,4298,50
PSCO,"10/10/2022 2 p.m. MDT",4372,4317,4437,65
PSCO,"10/10/2022 3 p.m. MDT",4417,4356,4538,121
PSCO,"10/10/2022 4 p.m. MDT",4553,4505,4533,-20
PSCO,"10/10/2022 5 p.m. MDT",4682,4727,4526,-156
PSCO,"10/10/2022 6 p.m. MDT",4890,4868,4729,-161
PSCO,"10/10/2022 7 p.m. MDT",4920,4888,4879,-41
PSCO,"10/10/2022 8 p.m. MDT",4899,4883,4961,62
PSCO,"10/10/2022 9 p.m. MDT",4715,4685,4766,51
PSCO,"10/10/2022 10 p.m. MDT",4443,4451,4401,-42
PSCO,"10/10/2022 11 p.m. MDT",4076,4128,4089,13
PSCO,"10/11/2022 12 a.m. MDT",3778,3879,3853,75
PSCO,"10/11/2022 1 a.m. MDT",3574,3747,3581,7
PSCO,"10/11/2022 2 a.m. MDT",3479,3648,3551,72
PSCO,"10/11/2022 3 a.m. MDT",3421,3500,3457,36
PSCO,"10/11/2022 4 a.m. MDT",3453,3500,3562,109
PSCO,"10/11/2022 5 a.m. MDT",3510,3569,3572,62
PSCO,"10/11/2022 6 a.m. MDT",3757,3836,3693,-64
PSCO,"10/11/2022 7 a.m. MDT",4233,4195,4116,-117
PSCO,"10/11/2022 8 a.m. MDT",4399,4347,4231,-168
PSCO,"10/11/2022 9 a.m. MDT",4386,4303,4274,-112
PSCO,"10/11/2022 10 a.m. MDT",4274,4246,4311,37
PSCO,"10/11/2022 11 a.m. MDT",4291,4226,4276,-15
PSCO,"10/11/2022 12 p.m. MDT",4390,4258,4358,-32
PSCO,"10/11/2022 1 p.m. MDT",4461,4341,4347,-114
PSCO,"10/11/2022 2 p.m. MDT",4637,4393,4506,-131
PSCO,"10/11/2022 3 p.m. MDT",4788,4437,4730,-58
PSCO,"10/11/2022 4 p.m. MDT",4766,4596,4690,-76
PSCO,"10/11/2022 5 p.m. MDT",4806,4718,4619,-187
PSCO,"10/11/2022 6 p.m. MDT",4885,4812,4746,-139
PSCO,"10/11/2022 7 p.m. MDT",4955,4991,4921,-34
PSCO,"10/11/2022 8 p.m. MDT",4898,5006,4840,-58
PSCO,"10/11/2022 9 p.m. MDT",4735,4792,4563,-172
PSCO,"10/11/2022 10 p.m. MDT",4465,4517,4434,-31
PSCO,"10/11/2022 11 p.m. MDT",4117,4218,4050,-67
PSCO,"10/12/2022 12 a.m. MDT",3854,3956,3688,-166
PSCO,"10/12/2022 1 a.m. MDT",3704,3728,3434,-270
PSCO,"10/12/2022 2 a.m. MDT",3589,3690,3503,-86
PSCO,"10/12/2022 3 a.m. MDT",3577,3526,3556,-21
PSCO,"10/12/2022 4 a.m. MDT",3579,3541,3511,-68
PSCO,"10/12/2022 5 a.m. MDT",3690,3604,3435,-255
PSCO,"10/12/2022 6 a.m. MDT",3916,3884,3691,-225
PSCO,"10/12/2022 7 a.m. MDT",4324,4290,3996,-328
PSCO,"10/12/2022 8 a.m. MDT",4526,4472,4255,-271
PSCO,"10/12/2022 9 a.m. MDT",4436,4393,4235,-201
PSCO,"10/12/2022 10 a.m. MDT",4302,4233,4145,-157
PSCO,"10/12/2022 11 a.m. MDT",4259,4180,4232,-27
PSCO,"10/12/2022 12 p.m. MDT",4276,4165,4291,15
PSCO,"10/12/2022 1 p.m. MDT",4287,4186,4328,41
PSCO,"10/12/2022 2 p.m. MDT",4312,4266,4249,-63
PSCO,"10/12/2022 3 p.m. MDT",4348,4358,4287,-61
PSCO,"10/12/2022 4 p.m. MDT",4413,4473,4398,-15
PSCO,"10/12/2022 5 p.m. MDT",4575,4603,4534,-41
PSCO,"10/12/2022 6 p.m. MDT",4729,4731,4592,-137
PSCO,"10/12/2022 7 p.m. MDT",4801,4814,4429,-372
PSCO,"10/12/2022 8 p.m. MDT",4780,4844,4528,-252
PSCO,"10/12/2022 9 p.m. MDT",4631,4658,4343,-288
PSCO,"10/12/2022 10 p.m. MDT",4386,4458,3993,-393
PSCO,"10/12/2022 11 p.m. MDT",4088,4163,3726,-362
PSCO,"10/13/2022 12 a.m. MDT",3826,3934,3488,-338
PSCO,"10/13/2022 1 a.m. MDT",3628,3774,3217,-411
PSCO,"10/13/2022 2 a.m. MDT",3617,3600,3301,-316
PSCO,"10/13/2022 3 a.m. MDT",3593,3577,3247,-346
PSCO,"10/13/2022 4 a.m. MDT",3565,3593,3209,-356
PSCO,"10/13/2022 5 a.m. MDT",3682,3660,3431,-251
PSCO,"10/13/2022 6 a.m. MDT",3966,3954,3607,-359
PSCO,"10/13/2022 7 a.m. MDT",4330,4368,3954,-376
PSCO,"10/13/2022 8 a.m. MDT",4474,4538,4005,-469
PSCO,"10/13/2022 9 a.m. MDT",4398,4438,3985,-413
PSCO,"10/13/2022 10 a.m. MDT",4276,4275,4132,-144
PSCO,"10/13/2022 11 a.m. MDT",4223,4175,4132,-91
PSCO,"10/13/2022 12 p.m. MDT",4184,4148,4062,-122
PSCO,"10/13/2022 1 p.m. MDT",4206,4107,4113,-93
PSCO,"10/13/2022 2 p.m. MDT",4249,4164,4108,-141
PSCO,"10/13/2022 3 p.m. MDT",4304,4279,4080,-224
PSCO,"10/13/2022 4 p.m. MDT",4400,4387,4155,-245
PSCO,"10/13/2022 5 p.m. MDT",4563,4566,4184,-379
PSCO,"10/13/2022 6 p.m. MDT",4658,4687,4081,-577
PSCO,"10/13/2022 7 p.m. MDT",4735,4788,4130,-605
PSCO,"10/13/2022 8 p.m. MDT",4754,4817,4159,-595
PSCO,"10/13/2022 9 p.m. MDT",4645,4633,4091,-554
PSCO,"10/13/2022 10 p.m. MDT",4458,4432,3947,-511
PSCO,"10/13/2022 11 p.m. MDT",4127,4156,3797,-330
PSCO,"10/14/2022 12 a.m. MDT",3912,3916,3640,-272
PSCO,"10/14/2022 1 a.m. MDT",3737,3769,3586,-151
PSCO,"10/14/2022 2 a.m. MDT",3659,3666,3543,-116
PSCO,"10/14/2022 3 a.m. MDT",3629,3608,3533,-96
PSCO,"10/14/2022 4 a.m. MDT",3645,3592,3504,-141
PSCO,"10/14/2022 5 a.m. MDT",3703,3651,3566,-137
PSCO,"10/14/2022 6 a.m. MDT",3939,3903,3646,-293
PSCO,"10/14/2022 7 a.m. MDT",4280,4269,3889,-391
PSCO,"10/14/2022 8 a.m. MDT",4479,4469,4071,-408
PSCO,"10/14/2022 9 a.m. MDT",4463,4364,4038,-425
PSCO,"10/14/2022 10 a.m. MDT",4358,4216,3953,-405
PSCO,"10/14/2022 11 a.m. MDT",4308,4142,3895,-413
PSCO,"10/14/2022 12 p.m. MDT",4349,4179,4076,-273
PSCO,"10/14/2022 1 p.m. MDT",4323,4174,3986,-337
PSCO,"10/14/2022 2 p.m. MDT",4400,4219,4107,-293
PSCO,"10/14/2022 3 p.m. MDT",4458,4268,4150,-308
PSCO,"10/14/2022 4 p.m. MDT",4571,4396,4221,-350
PSCO,"10/14/2022 5 p.m. MDT",4719,4477,4354,-365
PSCO,"10/14/2022 6 p.m. MDT",4834,4604,4363,-471
PSCO,"10/14/2022 7 p.m. MDT",4799,4650,4128,-671
PSCO,"10/14/2022 8 p.m. MDT",4709,4664,4238,-471
PSCO,"10/14/2022 9 p.m. MDT",4543,4514,3924,-619
PSCO,"10/14/2022 10 p.m. MDT",4324,4332,3768,-556
PSCO,"10/14/2022 11 p.m. MDT",4062,4104,3473,-589
PSCO,"10/15/2022 12 a.m. MDT",3834,3901,3255,-579
PSCO,"10/15/2022 1 a.m. MDT",3635,3704,3128,-507
PSCO,"10/15/2022 2 a.m. MDT",3503,3517,3097,-406
PSCO,"10/15/2022 3 a.m. MDT",3428,3486,3002,-426
PSCO,"10/15/2022 4 a.m. MDT",3429,3508,2992,-437
PSCO,"10/15/2022 5 a.m. MDT",3470,3523,3039,-431
PSCO,"10/15/2022 6 a.m. MDT",3569,3635,3160,-409
PSCO,"10/15/2022 7 a.m. MDT",3786,3818,3306,-480
PSCO,"10/15/2022 8 a.m. MDT",3910,3903,3440,-470
PSCO,"10/15/2022 9 a.m. MDT",3833,3928,3393,-440
PSCO,"10/15/2022 10 a.m. MDT",3778,3873,3331,-447
PSCO,"10/15/2022 11 a.m. MDT",3773,3802,3291,-482
PSCO,"10/15/2022 12 p.m. MDT",3844,3774,3336,-508
PSCO,"10/15/2022 1 p.m. MDT",3941,3831,3482,-459
PSCO,"10/15/2022 2 p.m. MDT",3921,3803,3501,-420
PSCO,"10/15/2022 3 p.m. MDT",3882,3817,3517,-365
PSCO,"10/15/2022 4 p.m. MDT",3892,3990,3503,-389
PSCO,"10/15/2022 5 p.m. MDT",4080,4093,3603,-477
PSCO,"10/15/2022 6 p.m. MDT",4307,4245,3806,-501
PSCO,"10/15/2022 7 p.m. MDT",4456,4458,4167,-289
PSCO,"10/15/2022 8 p.m. MDT",4469,4523,4201,-268
PSCO,"10/15/2022 9 p.m. MDT",4361,4340,4103,-258
PSCO,"10/15/2022 10 p.m. MDT",4185,4208,3940,-245
PSCO,"10/15/2022 11 p.m. MDT",3912,3988,3801,-111
PSCO,"10/16/2022 12 a.m. MDT",3685,3855,3741,56
PSCO,"10/16/2022 1 a.m. MDT",3526,3720,3580,54
PSCO,"10/16/2022 2 a.m. MDT",3442,3643,3507,65
PSCO,"10/16/2022 3 a.m. MDT",3415,3589,3410,-5
PSCO,"10/16/2022 4 a.m. MDT",3387,3525,3291,-96
PSCO,"10/16/2022 5 a.m. MDT",3401,3564,3342,-59
PSCO,"10/16/2022 6 a.m. MDT",3496,3625,3425,-71
PSCO,"10/16/2022 7 a.m. MDT",3637,3862,3486,-151
PSCO,"10/16/2022 8 a.m. MDT",3768,3906,3517,-251
PSCO,"10/16/2022 9 a.m. MDT",3936,3920,3602,-334
PSCO,"10/16/2022 10 a.m. MDT",4072,3981,3754,-318
PSCO,"10/16/2022 11 a.m. MDT",4103,4018,3744,-359
PSCO,"10/16/2022 12 p.m. MDT",4087,3998,3685,-402
PSCO,"10/16/2022 1 p.m. MDT",4001,4018,3722,-279
PSCO,"10/16/2022 2 p.m. MDT",3834,3997,3598,-236
PSCO,"10/16/2022 3 p.m. MDT",3809,4058,3469,-340
PSCO,"10/16/2022 4 p.m. MDT",3887,4031,3506,-381
PSCO,"10/16/2022 5 p.m. MDT",4042,4162,3570,-472
PSCO,"10/16/2022 6 p.m. MDT",4248,4515,3716,-532
PSCO,"10/16/2022 7 p.m. MDT",4480,4805,3997,-483
PSCO,"10/16/2022 8 p.m. MDT",4500,4935,4052,-448
PSCO,"10/16/2022 9 p.m. MDT",4372,4708,4046,-326
PSCO,"10/16/2022 10 p.m. MDT",4178,4488,3900,-278
PSCO,"10/16/2022 11 p.m. MDT",3904,4259,3625,-279
PSCO,"10/17/2022 12 a.m. MDT",3655,3968,3447,-208
PSCO,"10/17/2022 1 a.m. MDT",3513,3685,3334,-179
PSCO,"10/17/2022 2 a.m. MDT",3427,3648,3302,-125
PSCO,"10/17/2022 3 a.m. MDT",3402,3597,3250,-152
PSCO,"10/17/2022 4 a.m. MDT",3437,3607,3267,-170
PSCO,"10/17/2022 5 a.m. MDT",3562,3711,3386,-176
PSCO,"10/17/2022 6 a.m. MDT",3827,3977,3603,-224
PSCO,"10/17/2022 7 a.m. MDT",4246,4357,3861,-385
PSCO,"10/17/2022 8 a.m. MDT",4471,4568,4165,-306
PSCO,"10/17/2022 9 a.m. MDT",4390,4469,4179,-211
PSCO,"10/17/2022 10 a.m. MDT",4260,4356,4143,-117
PSCO,"10/17/2022 11 a.m. MDT",4150,4206,4093,-57
PSCO,"10/17/2022 12 p.m. MDT",4093,4187,3975,-118
PSCO,"10/17/2022 1 p.m. MDT",4068,4141,3953,-115
PSCO,"10/17/2022 2 p.m. MDT",4074,4138,3927,-147
PSCO,"10/17/2022 3 p.m. MDT",4107,4195,4016,-91
PSCO,"10/17/2022 4 p.m. MDT",4177,4303,4109,-68
PSCO,"10/17/2022 5 p.m. MDT",4323,4421,4163,-160
PSCO,"10/17/2022 6 p.m. MDT",4558,4637,4426,-132
PSCO,"10/17/2022 7 p.m. MDT",4707,4750,4641,-66
PSCO,"10/17/2022 8 p.m. MDT",4697,4781,4594,-103
PSCO,"10/17/2022 9 p.m. MDT",4521,4596,4514,-7
PSCO,"10/17/2022 10 p.m. MDT",4286,4406,4234,-52
PSCO,"10/17/2022 11 p.m. MDT",3989,4138,3841,-148
PSCO,"10/18/2022 12 a.m. MDT",3740,3881,3661,-79
PSCO,"10/18/2022 1 a.m. MDT",3585,3780,3509,-76
PSCO,"10/18/2022 2 a.m. MDT",3510,3723,3541,31
PSCO,"10/18/2022 3 a.m. MDT",3478,3680,3552,74
PSCO,"10/18/2022 4 a.m. MDT",3500,3684,3525,25
PSCO,"10/18/2022 5 a.m. MDT",3596,3767,3633,37
PSCO,"10/18/2022 6 a.m. MDT",3874,4039,3827,-47
PSCO,"10/18/2022 7 a.m. MDT",4278,4428,4177,-101
PSCO,"10/18/2022 8 a.m. MDT",4500,4642,4392,-108
PSCO,"10/18/2022 9 a.m. MDT",4404,4497,4302,-102
PSCO,"10/18/2022 10 a.m. MDT",4239,4342,4237,-2
PSCO,"10/18/2022 11 a.m. MDT",4153,4173,4187,34
PSCO,"10/18/2022 12 p.m. MDT",4101,4143,4063,-38
PSCO,"10/18/2022 1 p.m. MDT",4082,4126,4090,8
PSCO,"10/18/2022 2 p.m. MDT",4116,4169,4165,49
PSCO,"10/18/2022 3 p.m. MDT",4157,4204,4221,64
PSCO,"10/18/2022 4 p.m. MDT",4249,4276,4289,40
PSCO,"10/18/2022 5 p.m. MDT",4414,4425,4477,63
PSCO,"10/18/2022 6 p.m. MDT",4656,4626,4707,51
PSCO,"10/18/2022 7 p.m. MDT",4721,4728,4849,128
PSCO,"10/18/2022 8 p.m. MDT",4698,4728,4801,103
PSCO,"10/18/2022 9 p.m. MDT",4544,4591,4612,68
PSCO,"10/18/2022 10 p.m. MDT",4328,4400,4346,18
PSCO,"10/18/2022 11 p.m. MDT",4014,4139,4048,34
PSCO,"10/19/2022 12 a.m. MDT",3744,3884,3802,58
PSCO,"10/19/2022 1 a.m. MDT",3579,3691,3690,111
PSCO,"10/19/2022 2 a.m. MDT",3497,3488,3564,67
PSCO,"10/19/2022 3 a.m. MDT",3474,3455,3571,97
PSCO,"10/19/2022 4 a.m. MDT",3497,3417,3742,245
PSCO,"10/19/2022 5 a.m. MDT",3605,3537,3936,331
PSCO,"10/19/2022 6 a.m. MDT",3942,3869,4230,288
PSCO,"10/19/2022 7 a.m. MDT",4317,4304,4552,235
PSCO,"10/19/2022 8 a.m. MDT",4532,4563,4830,298
PSCO,"10/19/2022 9 a.m. MDT",4459,4442,4674,215
PSCO,"10/19/2022 10 a.m. MDT",4331,4260,4536,205
PSCO,"10/19/2022 11 a.m. MDT",4255,4211,4423,168
PSCO,"10/19/2022 12 p.m. MDT",4269,4218,4392,123
PSCO,"10/19/2022 1 p.m. MDT",4284,4235,4406,122
PSCO,"10/19/2022 2 p.m. MDT",4346,4282,4441,95
PSCO,"10/19/2022 3 p.m. MDT",4421,4314,4480,59
PSCO,"10/19/2022 4 p.m. MDT",4517,4455,4652,135
PSCO,"10/19/2022 5 p.m. MDT",4714,4629,4789,75
PSCO,"10/19/2022 6 p.m. MDT",4920,4817,5035,115
PSCO,"10/19/2022 7 p.m. MDT",4889,4890,5074,185
PSCO,"10/19/2022 8 p.m. MDT",4812,4832,4977,165
PSCO,"10/19/2022 9 p.m. MDT",4645,4704,4829,184
PSCO,"10/19/2022 10 p.m. MDT",4364,4450,4327,-37
PSCO,"10/19/2022 11 p.m. MDT",4001,4129,3902,-99
PSCO,"10/20/2022 12 a.m. MDT",3725,3887,3659,-66
PSCO,"10/20/2022 1 a.m. MDT",3580,3656,3587,7
PSCO,"10/20/2022 2 a.m. MDT",3551,3549,3415,-136
PSCO,"10/20/2022 3 a.m. MDT",3523,3550,3525,2
PSCO,"10/20/2022 4 a.m. MDT",3541,3495,3563,22
PSCO,"10/20/2022 5 a.m. MDT",3651,3624,3774,123
PSCO,"10/20/2022 6 a.m. MDT",3850,3906,3693,-157
PSCO,"10/20/2022 7 a.m. MDT",4213,4286,3999,-214
PSCO,"10/20/2022 8 a.m. MDT",4424,4522,4244,-180
PSCO,"10/20/2022 9 a.m. MDT",4350,4449,4201,-149
PSCO,"10/20/2022 10 a.m. MDT",4201,4279,4012,-189
PSCO,"10/20/2022 11 a.m. MDT",4176,4242,3967,-209
PSCO,"10/20/2022 12 p.m. MDT",4212,4311,4023,-189
PSCO,"10/20/2022 1 p.m. MDT",4268,4296,4095,-173
PSCO,"10/20/2022 2 p.m. MDT",4336,4333,4132,-204
PSCO,"10/20/2022 3 p.m. MDT",4413,4412,4193,-220
PSCO,"10/20/2022 4 p.m. MDT",4521,4574,4318,-203
PSCO,"10/20/2022 5 p.m. MDT",4684,4695,4449,-235
PSCO,"10/20/2022 6 p.m. MDT",4828,4828,4535,-293
PSCO,"10/20/2022 7 p.m. MDT",4854,4889,4756,-98
PSCO,"10/20/2022 8 p.m. MDT",4815,4769,4603,-212
PSCO,"10/20/2022 9 p.m. MDT",4673,4626,4603,-70
PSCO,"10/20/2022 10 p.m. MDT",4436,4432,4352,-84
PSCO,"10/20/2022 11 p.m. MDT",4106,4093,4010,-96
PSCO,"10/21/2022 12 a.m. MDT",3854,3871,3756,-98
PSCO,"10/21/2022 1 a.m. MDT",3686,3660,3518,-168
PSCO,"10/21/2022 2 a.m. MDT",3576,3507,3431,-145
PSCO,"10/21/2022 3 a.m. MDT",3549,3568,3368,-181
PSCO,"10/21/2022 4 a.m. MDT",3525,3643,3416,-109
PSCO,"10/21/2022 5 a.m. MDT",3631,3898,3549,-82
PSCO,"10/21/2022 6 a.m. MDT",3846,4120,3676,-170
PSCO,"10/21/2022 7 a.m. MDT",4201,4347,3967,-234
PSCO,"10/21/2022 8 a.m. MDT",4434,4314,4328,-106
PSCO,"10/21/2022 9 a.m. MDT",4461,4203,4404,-57
PSCO,"10/21/2022 10 a.m. MDT",4355,4164,4252,-103
PSCO,"10/21/2022 11 a.m. MDT",4266,4287,4233,-33
PSCO,"10/21/2022 12 p.m. MDT",4250,4312,4118,-132
PSCO,"10/21/2022 1 p.m. MDT",4273,4334,4111,-162
PSCO,"10/21/2022 2 p.m. MDT",4341,4460,4163,-178
PSCO,"10/21/2022 3 p.m. MDT",4429,4555,4296,-133
PSCO,"10/21/2022 4 p.m. MDT",4495,4646,4330,-165
PSCO,"10/21/2022 5 p.m. MDT",4641,4758,4340,-301
PSCO,"10/21/2022 6 p.m. MDT",4765,4721,4242,-523
PSCO,"10/21/2022 7 p.m. MDT",4761,4584,4288,-473
PSCO,"10/21/2022 8 p.m. MDT",4678,4434,4309,-369
PSCO,"10/21/2022 9 p.m. MDT",4517,4273,4350,-167
PSCO,"10/21/2022 10 p.m. MDT",4333,4024,4173,-160
PSCO,"10/21/2022 11 p.m. MDT",4100,3868,3926,-174
PSCO,"10/22/2022 12 a.m. MDT",3860,3653,3638,-222
PSCO,"10/22/2022 1 a.m. MDT",3664,3465,3622,-42
PSCO,"10/22/2022 2 a.m. MDT",3544,3461,3488,-56
PSCO,"10/22/2022 3 a.m. MDT",3487,3455,3445,-42
PSCO,"10/22/2022 4 a.m. MDT",3457,3493,3553,96
PSCO,"10/22/2022 5 a.m. MDT",3483,3603,3544,61
PSCO,"10/22/2022 6 a.m. MDT",3591,3822,3476,-115
PSCO,"10/22/2022 7 a.m. MDT",3784,3943,3644,-140
PSCO,"10/22/2022 8 a.m. MDT",3931,3932,3660,-271
PSCO,"10/22/2022 9 a.m. MDT",3927,3884,3819,-108
PSCO,"10/22/2022 10 a.m. MDT",3897,3865,3821,-76
PSCO,"10/22/2022 11 a.m. MDT",3897,3916,3826,-71
PSCO,"10/22/2022 12 p.m. MDT",3886,3999,3870,-16
PSCO,"10/22/2022 1 p.m. MDT",3946,4087,3855,-91
PSCO,"10/22/2022 2 p.m. MDT",3968,4136,3803,-165
PSCO,"10/22/2022 3 p.m. MDT",4078,4321,3874,-204
PSCO,"10/22/2022 4 p.m. MDT",4223,4503,4023,-200
PSCO,"10/22/2022 5 p.m. MDT",4432,4579,4232,-200
PSCO,"10/22/2022 6 p.m. MDT",4595,4650,4303,-292
PSCO,"10/22/2022 7 p.m. MDT",4702,4691,4585,-117
PSCO,"10/22/2022 8 p.m. MDT",4631,4481,4561,-70
PSCO,"10/22/2022 9 p.m. MDT",4484,4302,4405,-79
PSCO,"10/22/2022 10 p.m. MDT",4283,4043,4249,-34
PSCO,"10/22/2022 11 p.m. MDT",4048,3889,4019,-29
PSCO,"10/23/2022 12 a.m. MDT",3803,3688,3891,88
PSCO,"10/23/2022 1 a.m. MDT",3653,3616,3778,125
PSCO,"10/23/2022 2 a.m. MDT",3530,3574,3641,111
PSCO,"10/23/2022 3 a.m. MDT",3469,3514,3599,130
PSCO,"10/23/2022 4 a.m. MDT",3445,3538,3604,159
PSCO,"10/23/2022 5 a.m. MDT",3460,3585,3572,112
PSCO,"10/23/2022 6 a.m. MDT",3532,3749,3661,129
PSCO,"10/23/2022 7 a.m. MDT",3705,3853,3842,137
PSCO,"10/23/2022 8 a.m. MDT",3801,3855,3877,76
PSCO,"10/23/2022 9 a.m. MDT",3899,3832,3955,56
PSCO,"10/23/2022 10 a.m. MDT",3907,3793,4316,409
PSCO,"10/23/2022 11 a.m. MDT",3980,3828,4242,262
PSCO,"10/23/2022 12 p.m. MDT",4055,3934,4284,229
PSCO,"10/23/2022 1 p.m. MDT",4053,3934,4159,106
PSCO,"10/23/2022 2 p.m. MDT",4133,4007,4319,186
PSCO,"10/23/2022 3 p.m. MDT",4112,4021,4346,234
PSCO,"10/23/2022 4 p.m. MDT",4230,4028,4369,139
PSCO,"10/23/2022 5 p.m. MDT",4395,4318,4455,60
PSCO,"10/23/2022 6 p.m. MDT",4596,4739,4726,130
PSCO,"10/23/2022 7 p.m. MDT",4787,4698,4827,40
PSCO,"10/23/2022 8 p.m. MDT",4746,4447,4770,24
PSCO,"10/23/2022 9 p.m. MDT",4604,4113,4532,-72
PSCO,"10/23/2022 10 p.m. MDT",4402,3898,4335,-67
PSCO,"10/23/2022 11 p.m. MDT",4131,3783,4019,-112
PSCO,"10/24/2022 12 a.m. MDT",3878,3754,3814,-64
PSCO,"10/24/2022 1 a.m. MDT",3739,3672,3733,-6
PSCO,"10/24/2022 2 a.m. MDT",3639,3730,3694,55
PSCO,"10/24/2022 3 a.m. MDT",3620,3776,3485,-135
PSCO,"10/24/2022 4 a.m. MDT",3661,3953,3506,-155
PSCO,"10/24/2022 5 a.m. MDT",3770,4212,3574,-196
PSCO,"10/24/2022 6 a.m. MDT",4026,4672,3790,-236
PSCO,"10/24/2022 7 a.m. MDT",4431,4905,4090,-341
PSCO,"10/24/2022 8 a.m. MDT",4713,4878,4430,-283
PSCO,"10/24/2022 9 a.m. MDT",4678,4661,4441,-237
PSCO,"10/24/2022 10 a.m. MDT",4540,4525,4475,-65
PSCO,"10/24/2022 11 a.m. MDT",4492,4471,4442,-50
PSCO,"10/24/2022 12 p.m. MDT",4403,4323,4526,123
PSCO,"10/24/2022 1 p.m. MDT",4355,4308,4428,73
PSCO,"10/24/2022 2 p.m. MDT",4331,4240,4441,110
PSCO,"10/24/2022 3 p.m. MDT",4337,4312,4310,-27
PSCO,"10/24/2022 4 p.m. MDT",4376,4464,4295,-81
PSCO,"10/24/2022 5 p.m. MDT",4557,4720,4301,-256
PSCO,"10/24/2022 6 p.m. MDT",4854,4913,4428,-426
PSCO,"10/24/2022 7 p.m. MDT",5076,4950,4722,-354
PSCO,"10/24/2022 8 p.m. MDT",5054,4781,4855,-199
PSCO,"10/24/2022 9 p.m. MDT",4875,4605,4648,-227
PSCO,"10/24/2022 10 p.m. MDT",4666,4289,4468,-198
PSCO,"10/24/2022 11 p.m. MDT",4359,4082,4048,-311
PSCO,"10/25/2022 12 a.m. MDT",4111,3945,3875,-236
PSCO,"10/25/2022 1 a.m. MDT",3954,3910,3703,-251
PSCO,"10/25/2022 2 a.m. MDT",3864,3830,3728,-136
PSCO,"10/25/2022 3 a.m. MDT",3823,3839,3651,-172
PSCO,"10/25/2022 4 a.m. MDT",3846,3957,3645,-201
PSCO,"10/25/2022 5 a.m. MDT",3868,4294,3721,-147
PSCO,"10/25/2022 6 a.m. MDT",4250,4709,4056,-194
PSCO,"10/25/2022 7 a.m. MDT",4680,4874,4499,-181
PSCO,"10/25/2022 8 a.m. MDT",4888,4721,4834,-54
PSCO,"10/25/2022 9 a.m. MDT",4820,4526,4603,-217
PSCO,"10/25/2022 10 a.m. MDT",4709,4342,4685,-24
PSCO,"10/25/2022 11 a.m. MDT",4583,4246,4503,-80
PSCO,"10/25/2022 12 p.m. MDT",4457,4246,4327,-130
PSCO,"10/25/2022 1 p.m. MDT",4449,4279,4219,-230
PSCO,"10/25/2022 2 p.m. MDT",4480,4273,4263,-217
PSCO,"10/25/2022 3 p.m. MDT",4519,4327,4323,-196
PSCO,"10/25/2022 4 p.m. MDT",4592,4449,4501,-91
PSCO,"10/25/2022 5 p.m. MDT",4702,4608,4582,-120
PSCO,"10/25/2022 6 p.m. MDT",4853,4904,4875,22
PSCO,"10/25/2022 7 p.m. MDT",5035,4927,5067,32
PSCO,"10/25/2022 8 p.m. MDT",4997,4737,5064,67
PSCO,"10/25/2022 9 p.m. MDT",4856,4465,4811,-45
PSCO,"10/25/2022 10 p.m. MDT",4610,4155,4567,-43
PSCO,"10/25/2022 11 p.m. MDT",4337,3921,4118,-219
PSCO,"10/26/2022 12 a.m. MDT",4096,3856,3901,-195
PSCO,"10/26/2022 1 a.m. MDT",3909,3804,3835,-74
PSCO,"10/26/2022 2 a.m. MDT",3825,3659,3781,-44
PSCO,"10/26/2022 3 a.m. MDT",3770,3743,3687,-83
PSCO,"10/26/2022 4 a.m. MDT",3786,3801,3691,-95
PSCO,"10/26/2022 5 a.m. MDT",3904,4056,3821,-83
PSCO,"10/26/2022 6 a.m. MDT",4174,4512,4144,-30
PSCO,"10/26/2022 7 a.m. MDT",4605,4682,4651,46
PSCO,"10/26/2022 8 a.m. MDT",4859,4697,4914,55
PSCO,"10/26/2022 9 a.m. MDT",4892,4556,4921,29
PSCO,"10/26/2022 10 a.m. MDT",4764,4424,4697,-67
PSCO,"10/26/2022 11 a.m. MDT",4543,4343,4459,-84
PSCO,"10/26/2022 12 p.m. MDT",4547,4333,4535,-12
PSCO,"10/26/2022 1 p.m. MDT",4387,4346,4251,-136
PSCO,"10/26/2022 2 p.m. MDT",4394,4390,4191,-203
PSCO,"10/26/2022 3 p.m. MDT",4445,4409,4193,-252
PSCO,"10/26/2022 4 p.m. MDT",4507,4552,4242,-265
PSCO,"10/26/2022 5 p.m. MDT",4685,4735,4360,-325
PSCO,"10/26/2022 6 p.m. MDT",4910,5036,4528,-382
PSCO,"10/26/2022 7 p.m. MDT",5020,4965,4723,-297
PSCO,"10/26/2022 8 p.m. MDT",4965,4795,4715,-250
PSCO,"10/26/2022 9 p.m. MDT",4829,4572,4533,-296
PSCO,"10/26/2022 10 p.m. MDT",4597,4281,4301,-296
PSCO,"10/26/2022 11 p.m. MDT",4311,4043,4045,-266
PSCO,"10/27/2022 12 a.m. MDT",4070,3927,3886,-184
PSCO,"10/27/2022 1 a.m. MDT",3907,3849,3741,-166
PSCO,"10/27/2022 2 a.m. MDT",3826,3800,3610,-216
PSCO,"10/27/2022 3 a.m. MDT",3791,3806,3593,-198
PSCO,"10/27/2022 4 a.m. MDT",3814,3947,3725,-89
PSCO,"10/27/2022 5 a.m. MDT",3923,4209,3801,-122
PSCO,"10/27/2022 6 a.m. MDT",4201,4599,4103,-98
PSCO,"10/27/2022 7 a.m. MDT",4659,4823,4608,-51
PSCO,"10/27/2022 8 a.m. MDT",5021,4816,4999,-22
PSCO,"10/27/2022 9 a.m. MDT",5205,4768,5174,-31
PSCO,"10/27/2022 10 a.m. MDT",5293,4650,5122,-171
PSCO,"10/27/2022 11 a.m. MDT",5295,4600,5148,-147
PSCO,"10/27/2022 12 p.m. MDT",5241,4572,5132,-109
PSCO,"10/27/2022 1 p.m. MDT",5121,4544,5062,-59
PSCO,"10/27/2022 2 p.m. MDT",4981,4544,4980,-1
PSCO,"10/27/2022 3 p.m. MDT",4927,4582,4883,-44
PSCO,"10/27/2022 4 p.m. MDT",4833,4657,4797,-36
PSCO,"10/27/2022 5 p.m. MDT",4816,4857,4773,-43
PSCO,"10/27/2022 6 p.m. MDT",5060,5065,4898,-162
PSCO,"10/27/2022 7 p.m. MDT",5269,4967,5020,-249
PSCO,"10/27/2022 8 p.m. MDT",5230,4826,5135,-95
PSCO,"10/27/2022 9 p.m. MDT",5049,4625,5066,17
PSCO,"10/27/2022 10 p.m. MDT",4825,4333,4779,-46
PSCO,"10/27/2022 11 p.m. MDT",4532,4129,4387,-145
PSCO,"10/28/2022 12 a.m. MDT",4259,4045,4159,-100
PSCO,"10/28/2022 1 a.m. MDT",4092,4054,4025,-67
PSCO,"10/28/2022 2 a.m. MDT",4051,4026,3914,-137
PSCO,"10/28/2022 3 a.m. MDT",4047,3966,3848,-199
PSCO,"10/28/2022 4 a.m. MDT",4066,3996,3804,-262
PSCO,"10/28/2022 5 a.m. MDT",4259,4102,4118,-141
PSCO,"10/28/2022 6 a.m. MDT",4453,4374,4422,-31
PSCO,"10/28/2022 7 a.m. MDT",4853,4797,4748,-105
PSCO,"10/28/2022 8 a.m. MDT",5099,5031,4869,-230
PSCO,"10/28/2022 9 a.m. MDT",4948,4815,4781,-167
PSCO,"10/28/2022 10 a.m. MDT",4676,4658,4415,-261
PSCO,"10/28/2022 11 a.m. MDT",4504,4397,4284,-220
PSCO,"10/28/2022 12 p.m. MDT",4424,4284,4248,-176
PSCO,"10/28/2022 1 p.m. MDT",4349,4205,4150,-199
PSCO,"10/28/2022 2 p.m. MDT",4293,4189,4075,-218
PSCO,"10/28/2022 3 p.m. MDT",4246,4148,4085,-161
PSCO,"10/28/2022 4 p.m. MDT",4286,4164,4070,-216
PSCO,"10/28/2022 5 p.m. MDT",4456,4331,4154,-302
PSCO,"10/28/2022 6 p.m. MDT",4654,4548,4437,-217
PSCO,"10/28/2022 7 p.m. MDT",4840,4712,4695,-145
PSCO,"10/28/2022 8 p.m. MDT",4807,4613,4581,-226
PSCO,"10/28/2022 9 p.m. MDT",4755,4509,4607,-148
PSCO,"10/28/2022 10 p.m. MDT",4590,4336,4703,113
PSCO,"10/28/2022 11 p.m. MDT",4398,4170,4468,70
PSCO,"10/29/2022 12 a.m. MDT",4198,3977,4250,52
PSCO,"10/29/2022 1 a.m. MDT",4053,3970,4124,71
PSCO,"10/29/2022 2 a.m. MDT",3970,3833,4166,196
PSCO,"10/29/2022 3 a.m. MDT",3935,3822,4126,191
PSCO,"10/29/2022 4 a.m. MDT",4012,3832,4207,195
PSCO,"10/29/2022 5 a.m. MDT",4007,3894,4046,39
PSCO,"10/29/2022 6 a.m. MDT",4091,3985,4048,-43
PSCO,"10/29/2022 7 a.m. MDT",4285,4199,4229,-56
PSCO,"10/29/2022 8 a.m. MDT",4455,4328,4300,-155
PSCO,"10/29/2022 9 a.m. MDT",4422,4242,4392,-30
PSCO,"10/29/2022 10 a.m. MDT",4245,4147,4139,-106
PSCO,"10/29/2022 11 a.m. MDT",4128,4020,3949,-179
PSCO,"10/29/2022 12 p.m. MDT",4041,3979,3741,-300
PSCO,"10/29/2022 1 p.m. MDT",3955,3896,3540,-415
PSCO,"10/29/2022 2 p.m. MDT",3906,3918,3499,-407
PSCO,"10/29/2022 3 p.m. MDT",3921,3878,3522,-399
PSCO,"10/29/2022 4 p.m. MDT",4062,3985,3673,-389
PSCO,"10/29/2022 5 p.m. MDT",4233,4108,3895,-338
PSCO,"10/29/2022 6 p.m. MDT",4445,4293,4186,-259
PSCO,"10/29/2022 7 p.m. MDT",4658,4603,4463,-195
PSCO,"10/29/2022 8 p.m. MDT",4611,4516,4407,-204
PSCO,"10/29/2022 9 p.m. MDT",4516,4410,4366,-150
PSCO,"10/29/2022 10 p.m. MDT",4380,4295,4254,-126
PSCO,"10/29/2022 11 p.m. MDT",4199,4117,4049,-150
PSCO,"10/30/2022 12 a.m. MDT",4035,3956,3970,-65
PSCO,"10/30/2022 1 a.m. MDT",3893,4007,3872,-21
PSCO,"10/30/2022 2 a.m. MDT",3830,3912,3771,-59
PSCO,"10/30/2022 3 a.m. MDT",3794,3870,3735,-59
PSCO,"10/30/2022 4 a.m. MDT",3793,3825,3728,-65
PSCO,"10/30/2022 5 a.m. MDT",3837,3871,3806,-31
PSCO,"10/30/2022 6 a.m. MDT",3940,3963,3902,-38
PSCO,"10/30/2022 7 a.m. MDT",4088,4155,4004,-84
PSCO,"10/30/2022 8 a.m. MDT",4269,4232,4259,-10
PSCO,"10/30/2022 9 a.m. MDT",4327,4244,4231,-96
PSCO,"10/30/2022 10 a.m. MDT",4167,4225,4193,26
PSCO,"10/30/2022 11 a.m. MDT",4067,4245,3856,-211
PSCO,"10/30/2022 12 p.m. MDT",4028,4214,3808,-220
PSCO,"10/30/2022 1 p.m. MDT",3948,4185,3642,-306
PSCO,"10/30/2022 2 p.m. MDT",3916,4173,3567,-349
PSCO,"10/30/2022 3 p.m. MDT",3929,4186,3537,-392
PSCO,"10/30/2022 4 p.m. MDT",4086,4217,3742,-344
PSCO,"10/30/2022 5 p.m. MDT",4295,4310,4137,-158
PSCO,"10/30/2022 6 p.m. MDT",4566,4547,4390,-176
PSCO,"10/30/2022 7 p.m. MDT",4817,4891,4687,-130
PSCO,"10/30/2022 8 p.m. MDT",4768,5005,4693,-75
PSCO,"10/30/2022 9 p.m. MDT",4656,4808,4482,-174
PSCO,"10/30/2022 10 p.m. MDT",4454,4635,4186,-268
PSCO,"10/30/2022 11 p.m. MDT",4226,4351,3917,-309
PSCO,"10/31/2022 12 a.m. MDT",3969,4084,3919,-50
PSCO,"10/31/2022 1 a.m. MDT",3848,3797,3910,62
PSCO,"10/31/2022 2 a.m. MDT",3791,3756,3892,101
PSCO,"10/31/2022 3 a.m. MDT",3777,3748,3873,96
PSCO,"10/31/2022 4 a.m. MDT",3824,3761,4009,185
PSCO,"10/31/2022 5 a.m. MDT",3960,3845,4101,141
PSCO,"10/31/2022 6 a.m. MDT",4248,4139,4311,63
PSCO,"10/31/2022 7 a.m. MDT",4658,4500,4780,122
PSCO,"10/31/2022 8 a.m. MDT",4926,4772,5009,83
PSCO,"10/31/2022 9 a.m. MDT",4815,4628,4872,57
PSCO,"10/31/2022 10 a.m. MDT",4601,4509,4443,-158
PSCO,"10/31/2022 11 a.m. MDT",4457,4284,4266,-191
PSCO,"10/31/2022 12 p.m. MDT",4369,4319,4160,-209
PSCO,"10/31/2022 1 p.m. MDT",4332,4229,4107,-225
PSCO,"10/31/2022 2 p.m. MDT",4335,4232,4091,-244
PSCO,"10/31/2022 3 p.m. MDT",4336,4189,4107,-229
PSCO,"10/31/2022 4 p.m. MDT",4402,4282,4192,-210
PSCO,"10/31/2022 5 p.m. MDT",4585,4433,4341,-244
PSCO,"10/31/2022 6 p.m. MDT",4764,4637,4528,-236
PSCO,"10/31/2022 7 p.m. MDT",4793,4698,4620,-173
PSCO,"10/31/2022 8 p.m. MDT",4722,4660,4601,-121
PSCO,"10/31/2022 9 p.m. MDT",4634,4533,4409,-225
PSCO,"10/31/2022 10 p.m. MDT",4500,4384,4254,-246
PSCO,"10/31/2022 11 p.m. MDT",4236,4115,4041,-195
PSCO,"11/1/2022 12 a.m. MDT",4034,3925,3890,-144
