"BA Code","Timestamp (Hour Ending)","Demand (MWh)","Demand Forecast (MWh)","Net Generation (MWh)","Total Interchange (MWh)"
PSCO,"9/1/2022 12 a.m. MDT",4900,5038,4831,-69
PSCO,"9/1/2022 1 a.m. MDT",4644,4689,4752,108
PSCO,"9/1/2022 2 a.m. MDT",4446,4467,4512,66
PSCO,"9/1/2022 3 a.m. MDT",4210,4262,4264,54
PSCO,"9/1/2022 4 a.m. MDT",4141,4169,4212,71
PSCO,"9/1/2022 5 a.m. MDT",4188,4205,4277,89
PSCO,"9/1/2022 6 a.m. MDT",4315,4344,4449,134
PSCO,"9/1/2022 7 a.m. MDT",4525,4610,4548,23
PSCO,"9/1/2022 8 a.m. MDT",4538,4784,4675,137
PSCO,"9/1/2022 9 a.m. MDT",4680,4952,4681,1
PSCO,"9/1/2022 10 a.m. MDT",4911,5239,4977,66
PSCO,"9/1/2022 11 a.m. MDT",5182,5533,5173,-9
PSCO,"9/1/2022 12 p.m. MDT",5537,5874,5577,40
PSCO,"9/1/2022 1 p.m. MDT",5974,6257,6058,84
PSCO,"9/1/2022 2 p.m. MDT",6429,6638,6432,3
PSCO,"9/1/2022 3 p.m. MDT",6757,6976,6837,80
PSCO,"9/1/2022 4 p.m. MDT",7013,7274,7040,27
PSCO,"9/1/2022 5 p.m. MDT",7342,7654,7152,-190
PSCO,"9/1/2022 6 p.m. MDT",7395,7641,7112,-283
PSCO,"9/1/2022 7 p.m. MDT",7148,7347,7229,81
PSCO,"9/1/2022 8 p.m. MDT",6960,7015,6888,-72
PSCO,"9/1/2022 9 p.m. MDT",6636,6858,6676,40
PSCO,"9/1/2022 10 p.m. MDT",6079,6291,6325,246
PSCO,"9/1/2022 11 p.m. MDT",5425,5704,5559,134
PSCO,"9/2/2022 12 a.m. MDT",5096,5201,5310,214
PSCO,"9/2/2022 1 a.m. MDT",4833,4737,5154,321
PSCO,"9/2/2022 2 a.m. MDT",4596,4521,4886,290
PSCO,"9/2/2022 3 a.m. MDT",4419,4301,4692,273
PSCO,"9/2/2022 4 a.m. MDT",4306,4102,4699,393
PSCO,"9/2/2022 5 a.m. MDT",4241,4136,4746,505
PSCO,"9/2/2022 6 a.m. MDT",4223,4249,4687,464
PSCO,"9/2/2022 7 a.m. MDT",4503,4462,4712,209
PSCO,"9/2/2022 8 a.m. MDT",4610,4605,4717,107
PSCO,"9/2/2022 9 a.m. MDT",4795,4813,4916,121
PSCO,"9/2/2022 10 a.m. MDT",5043,5103,5192,149
PSCO,"9/2/2022 11 a.m. MDT",5340,5433,5545,205
PSCO,"9/2/2022 12 p.m. MDT",5768,5802,5861,93
PSCO,"9/2/2022 1 p.m. MDT",6203,6234,6357,154
PSCO,"9/2/2022 2 p.m. MDT",6601,6600,6759,158
PSCO,"9/2/2022 3 p.m. MDT",6978,6939,7305,327
PSCO,"9/2/2022 4 p.m. MDT",7232,7267,7702,470
PSCO,"9/2/2022 5 p.m. MDT",7447,7605,7741,294
PSCO,"9/2/2022 6 p.m. MDT",7555,7481,7984,429
PSCO,"9/2/2022 7 p.m. MDT",7308,7050,7636,328
PSCO,"9/2/2022 8 p.m. MDT",6973,6585,7122,149
PSCO,"9/2/2022 9 p.m. MDT",6582,6352,6589,7
PSCO,"9/2/2022 10 p.m. MDT",5965,5914,6067,102
PSCO,"9/2/2022 11 p.m. MDT",5426,5476,5519,93
PSCO,"9/3/2022 12 a.m. MDT",5082,5072,5189,107
PSCO,"9/3/2022 1 a.m. MDT",4856,4595,4930,74
PSCO,"9/3/2022 2 a.m. MDT",4545,4315,4605,60
PSCO,"9/3/2022 3 a.m. MDT",4365,4191,4478,113
PSCO,"9/3/2022 4 a.m. MDT",4122,4077,4237,115
PSCO,"9/3/2022 5 a.m. MDT",4027,4008,4133,106
PSCO,"9/3/2022 6 a.m. MDT",3982,4093,4123,141
PSCO,"9/3/2022 7 a.m. MDT",4103,4108,4317,214
PSCO,"9/3/2022 8 a.m. MDT",4042,4142,4168,126
PSCO,"9/3/2022 9 a.m. MDT",4133,4275,4241,108
PSCO,"9/3/2022 10 a.m. MDT",4393,4494,4436,43
PSCO,"9/3/2022 11 a.m. MDT",4613,4749,4668,55
PSCO,"9/3/2022 12 p.m. MDT",4912,5063,4968,56
PSCO,"9/3/2022 1 p.m. MDT",5268,5418,5361,93
PSCO,"9/3/2022 2 p.m. MDT",5620,5832,5764,144
PSCO,"9/3/2022 3 p.m. MDT",5976,6153,6200,224
PSCO,"9/3/2022 4 p.m. MDT",6279,6473,6445,166
PSCO,"9/3/2022 5 p.m. MDT",6631,6782,6593,-38
PSCO,"9/3/2022 6 p.m. MDT",6842,6817,6809,-33
PSCO,"9/3/2022 7 p.m. MDT",6711,6633,6694,-17
PSCO,"9/3/2022 8 p.m. MDT",6397,6266,6274,-123
PSCO,"9/3/2022 9 p.m. MDT",6048,6104,6256,208
PSCO,"9/3/2022 10 p.m. MDT",5675,5708,5819,144
PSCO,"9/3/2022 11 p.m. MDT",5236,5247,5384,148
PSCO,"9/4/2022 12 a.m. MDT",4886,4878,5023,137
PSCO,"9/4/2022 1 a.m. MDT",4599,4503,4825,226
PSCO,"9/4/2022 2 a.m. MDT",4389,4232,4426,37
PSCO,"9/4/2022 3 a.m. MDT",4200,4050,4218,18
PSCO,"9/4/2022 4 a.m. MDT",4083,3908,4118,35
PSCO,"9/4/2022 5 a.m. MDT",4064,3796,4108,44
PSCO,"9/4/2022 6 a.m. MDT",4074,3817,4168,94
PSCO,"9/4/2022 7 a.m. MDT",3907,3872,4054,147
PSCO,"9/4/2022 8 a.m. MDT",3874,3911,4018,144
PSCO,"9/4/2022 9 a.m. MDT",4025,4062,4084,59
PSCO,"9/4/2022 10 a.m. MDT",4210,4256,4435,225
PSCO,"9/4/2022 11 a.m. MDT",4488,4577,4625,137
PSCO,"9/4/2022 12 p.m. MDT",4914,4925,5104,190
PSCO,"9/4/2022 1 p.m. MDT",5362,5356,5515,153
PSCO,"9/4/2022 2 p.m. MDT",5794,5820,5961,167
PSCO,"9/4/2022 3 p.m. MDT",6239,6290,6428,189
PSCO,"9/4/2022 4 p.m. MDT",6628,6687,6754,126
PSCO,"9/4/2022 5 p.m. MDT",7008,6928,7101,93
PSCO,"9/4/2022 6 p.m. MDT",7202,7092,7338,136
PSCO,"9/4/2022 7 p.m. MDT",7195,6979,7302,107
PSCO,"9/4/2022 8 p.m. MDT",6722,6673,6942,220
PSCO,"9/4/2022 9 p.m. MDT",6366,6393,6418,52
PSCO,"9/4/2022 10 p.m. MDT",5872,5870,5975,103
PSCO,"9/4/2022 11 p.m. MDT",5367,5486,5458,91
PSCO,"9/5/2022 12 a.m. MDT",4977,5010,5193,216
PSCO,"9/5/2022 1 a.m. MDT",4642,4515,4848,206
PSCO,"9/5/2022 2 a.m. MDT",4474,4242,4588,114
PSCO,"9/5/2022 3 a.m. MDT",4280,4071,4365,85
PSCO,"9/5/2022 4 a.m. MDT",4217,3920,4311,94
PSCO,"9/5/2022 5 a.m. MDT",4191,3927,4254,63
PSCO,"9/5/2022 6 a.m. MDT",4222,3951,4302,80
PSCO,"9/5/2022 7 a.m. MDT",4227,4059,4198,-29
PSCO,"9/5/2022 8 a.m. MDT",4102,4057,4034,-68
PSCO,"9/5/2022 9 a.m. MDT",4314,4238,4216,-98
PSCO,"9/5/2022 10 a.m. MDT",4610,4501,4553,-57
PSCO,"9/5/2022 11 a.m. MDT",4996,4844,4985,-11
PSCO,"9/5/2022 12 p.m. MDT",5435,5275,5497,62
PSCO,"9/5/2022 1 p.m. MDT",5902,5782,6033,131
PSCO,"9/5/2022 2 p.m. MDT",6367,6243,6460,93
PSCO,"9/5/2022 3 p.m. MDT",6805,6670,6886,81
PSCO,"9/5/2022 4 p.m. MDT",7267,7062,7335,68
PSCO,"9/5/2022 5 p.m. MDT",7642,7300,7673,31
PSCO,"9/5/2022 6 p.m. MDT",7797,7503,7864,67
PSCO,"9/5/2022 7 p.m. MDT",7668,7371,7877,209
PSCO,"9/5/2022 8 p.m. MDT",7365,7080,7736,371
PSCO,"9/5/2022 9 p.m. MDT",6952,6790,7005,53
PSCO,"9/5/2022 10 p.m. MDT",6480,6199,6372,-108
PSCO,"9/5/2022 11 p.m. MDT",5850,5632,5879,29
PSCO,"9/6/2022 12 a.m. MDT",5393,5052,5435,42
PSCO,"9/6/2022 1 a.m. MDT",4954,4659,4973,19
PSCO,"9/6/2022 2 a.m. MDT",4707,4385,4899,192
PSCO,"9/6/2022 3 a.m. MDT",4501,4168,4674,173
PSCO,"9/6/2022 4 a.m. MDT",4394,4028,4533,139
PSCO,"9/6/2022 5 a.m. MDT",4405,4111,4495,90
PSCO,"9/6/2022 6 a.m. MDT",4511,4259,4538,27
PSCO,"9/6/2022 7 a.m. MDT",4641,4539,4661,20
PSCO,"9/6/2022 8 a.m. MDT",4764,4677,4852,88
PSCO,"9/6/2022 9 a.m. MDT",4966,4895,4981,15
PSCO,"9/6/2022 10 a.m. MDT",5269,5166,5387,118
PSCO,"9/6/2022 11 a.m. MDT",5655,5451,5733,78
PSCO,"9/6/2022 12 p.m. MDT",6097,5831,6208,111
PSCO,"9/6/2022 1 p.m. MDT",6578,6293,6654,76
PSCO,"9/6/2022 2 p.m. MDT",7085,6754,7167,82
PSCO,"9/6/2022 3 p.m. MDT",7516,7288,7708,192
PSCO,"9/6/2022 4 p.m. MDT",7787,7735,7848,61
PSCO,"9/6/2022 5 p.m. MDT",7990,8048,8006,16
PSCO,"9/6/2022 6 p.m. MDT",8139,8051,8141,2
PSCO,"9/6/2022 7 p.m. MDT",7924,7762,7958,34
PSCO,"9/6/2022 8 p.m. MDT",7711,7468,7576,-135
PSCO,"9/6/2022 9 p.m. MDT",7325,7078,7275,-50
PSCO,"9/6/2022 10 p.m. MDT",6642,6487,6615,-27
PSCO,"9/6/2022 11 p.m. MDT",6035,5779,6188,153
PSCO,"9/7/2022 12 a.m. MDT",5629,5233,5684,55
PSCO,"9/7/2022 1 a.m. MDT",5186,5070,5503,317
PSCO,"9/7/2022 2 a.m. MDT",4822,4877,5139,317
PSCO,"9/7/2022 3 a.m. MDT",4566,4664,4809,243
PSCO,"9/7/2022 4 a.m. MDT",4389,4434,4554,165
PSCO,"9/7/2022 5 a.m. MDT",4247,4405,4383,136
PSCO,"9/7/2022 6 a.m. MDT",4313,4555,4371,58
PSCO,"9/7/2022 7 a.m. MDT",4578,4843,4564,-14
PSCO,"9/7/2022 8 a.m. MDT",4655,4958,4754,99
PSCO,"9/7/2022 9 a.m. MDT",4823,5106,4795,-28
PSCO,"9/7/2022 10 a.m. MDT",5055,5366,5065,10
PSCO,"9/7/2022 11 a.m. MDT",5418,5743,5445,27
PSCO,"9/7/2022 12 p.m. MDT",5813,6188,5906,93
PSCO,"9/7/2022 1 p.m. MDT",6282,6675,6403,121
PSCO,"9/7/2022 2 p.m. MDT",6855,7246,6945,90
PSCO,"9/7/2022 3 p.m. MDT",7309,7712,7461,152
PSCO,"9/7/2022 4 p.m. MDT",7696,8031,7880,184
PSCO,"9/7/2022 5 p.m. MDT",7979,8300,8127,148
PSCO,"9/7/2022 6 p.m. MDT",8067,8415,8271,204
PSCO,"9/7/2022 7 p.m. MDT",7846,8149,7973,127
PSCO,"9/7/2022 8 p.m. MDT",7432,7607,7532,100
PSCO,"9/7/2022 9 p.m. MDT",7058,7345,7175,117
PSCO,"9/7/2022 10 p.m. MDT",6489,6691,6631,142
PSCO,"9/7/2022 11 p.m. MDT",5968,6004,6008,40
PSCO,"9/8/2022 12 a.m. MDT",5550,5428,5599,49
PSCO,"9/8/2022 1 a.m. MDT",5182,4992,5511,329
PSCO,"9/8/2022 2 a.m. MDT",4886,4767,5350,464
PSCO,"9/8/2022 3 a.m. MDT",4663,4581,5125,462
PSCO,"9/8/2022 4 a.m. MDT",4518,4410,4980,462
PSCO,"9/8/2022 5 a.m. MDT",4495,4403,4798,303
PSCO,"9/8/2022 6 a.m. MDT",4596,4548,5000,404
PSCO,"9/8/2022 7 a.m. MDT",4832,4794,4983,151
PSCO,"9/8/2022 8 a.m. MDT",4932,4874,5099,167
PSCO,"9/8/2022 9 a.m. MDT",5100,5102,5137,37
PSCO,"9/8/2022 10 a.m. MDT",5399,5416,5455,56
PSCO,"9/8/2022 11 a.m. MDT",5790,5812,5867,77
PSCO,"9/8/2022 12 p.m. MDT",6297,6334,6464,167
PSCO,"9/8/2022 1 p.m. MDT",6792,6787,6830,38
PSCO,"9/8/2022 2 p.m. MDT",7193,7343,7235,42
PSCO,"9/8/2022 3 p.m. MDT",7453,7891,7538,85
PSCO,"9/8/2022 4 p.m. MDT",7681,8159,7911,230
PSCO,"9/8/2022 5 p.m. MDT",7739,8291,7741,2
PSCO,"9/8/2022 6 p.m. MDT",7560,8205,7482,-78
PSCO,"9/8/2022 7 p.m. MDT",7249,7946,7156,-93
PSCO,"9/8/2022 8 p.m. MDT",6995,7474,7008,13
PSCO,"9/8/2022 9 p.m. MDT",6717,7101,6675,-42
PSCO,"9/8/2022 10 p.m. MDT",6193,6448,6040,-153
PSCO,"9/8/2022 11 p.m. MDT",5668,5677,5642,-26
PSCO,"9/9/2022 12 a.m. MDT",5252,5231,5124,-128
PSCO,"9/9/2022 1 a.m. MDT",4815,4706,4874,59
PSCO,"9/9/2022 2 a.m. MDT",4524,4368,4706,182
PSCO,"9/9/2022 3 a.m. MDT",4351,4190,4468,117
PSCO,"9/9/2022 4 a.m. MDT",4217,4069,4586,369
PSCO,"9/9/2022 5 a.m. MDT",4266,4060,4665,399
PSCO,"9/9/2022 6 a.m. MDT",4373,4288,4739,366
PSCO,"9/9/2022 7 a.m. MDT",4589,4471,4872,283
PSCO,"9/9/2022 8 a.m. MDT",4696,4504,4953,257
PSCO,"9/9/2022 9 a.m. MDT",4726,4570,5107,381
PSCO,"9/9/2022 10 a.m. MDT",4653,4655,5084,431
PSCO,"9/9/2022 11 a.m. MDT",4763,4702,5045,282
PSCO,"9/9/2022 12 p.m. MDT",4700,4813,4944,244
PSCO,"9/9/2022 1 p.m. MDT",4736,4914,4907,171
PSCO,"9/9/2022 2 p.m. MDT",4772,5082,4974,202
PSCO,"9/9/2022 3 p.m. MDT",4803,5171,4790,-13
PSCO,"9/9/2022 4 p.m. MDT",4925,5240,4996,71
PSCO,"9/9/2022 5 p.m. MDT",4914,5333,5110,196
PSCO,"9/9/2022 6 p.m. MDT",4926,5346,5034,108
PSCO,"9/9/2022 7 p.m. MDT",4911,5219,4815,-96
PSCO,"9/9/2022 8 p.m. MDT",4828,5127,4778,-50
PSCO,"9/9/2022 9 p.m. MDT",4678,5000,4497,-181
PSCO,"9/9/2022 10 p.m. MDT",4424,4764,4242,-182
PSCO,"9/9/2022 11 p.m. MDT",4333,4473,4194,-139
PSCO,"9/10/2022 12 a.m. MDT",4112,4190,4087,-25
PSCO,"9/10/2022 1 a.m. MDT",3878,3832,3875,-3
PSCO,"9/10/2022 2 a.m. MDT",3766,3674,3718,-48
PSCO,"9/10/2022 3 a.m. MDT",3688,3571,3679,-9
PSCO,"9/10/2022 4 a.m. MDT",3659,3617,3660,1
PSCO,"9/10/2022 5 a.m. MDT",3539,3601,3580,41
PSCO,"9/10/2022 6 a.m. MDT",3583,3634,3728,145
PSCO,"9/10/2022 7 a.m. MDT",3697,3780,3767,70
PSCO,"9/10/2022 8 a.m. MDT",3835,3817,3803,-32
PSCO,"9/10/2022 9 a.m. MDT",3994,3890,3812,-182
PSCO,"9/10/2022 10 a.m. MDT",4083,3946,3835,-248
PSCO,"9/10/2022 11 a.m. MDT",4156,3964,3919,-237
PSCO,"9/10/2022 12 p.m. MDT",3775,3999,3517,-258
PSCO,"9/10/2022 1 p.m. MDT",4188,4024,4041,-147
PSCO,"9/10/2022 2 p.m. MDT",4193,4091,4046,-147
PSCO,"9/10/2022 3 p.m. MDT",4180,4116,4011,-169
PSCO,"9/10/2022 4 p.m. MDT",4205,4180,4024,-181
PSCO,"9/10/2022 5 p.m. MDT",4297,4291,4034,-263
PSCO,"9/10/2022 6 p.m. MDT",4368,4375,4123,-245
PSCO,"9/10/2022 7 p.m. MDT",4403,4455,4002,-401
PSCO,"9/10/2022 8 p.m. MDT",4454,4596,4075,-379
PSCO,"9/10/2022 9 p.m. MDT",4366,4494,4041,-325
PSCO,"9/10/2022 10 p.m. MDT",4194,4354,3857,-337
PSCO,"9/10/2022 11 p.m. MDT",3979,4096,3666,-313
PSCO,"9/11/2022 12 a.m. MDT",3765,3920,3609,-156
PSCO,"9/11/2022 1 a.m. MDT",3725,3866,3438,-287
PSCO,"9/11/2022 2 a.m. MDT",3688,3718,3505,-183
PSCO,"9/11/2022 3 a.m. MDT",3583,3633,3444,-139
PSCO,"9/11/2022 4 a.m. MDT",3549,3589,3505,-44
PSCO,"9/11/2022 5 a.m. MDT",3573,3573,3512,-61
PSCO,"9/11/2022 6 a.m. MDT",3595,3638,3622,27
PSCO,"9/11/2022 7 a.m. MDT",3653,3775,3501,-152
PSCO,"9/11/2022 8 a.m. MDT",3680,3743,3437,-243
PSCO,"9/11/2022 9 a.m. MDT",3679,3847,3588,-91
PSCO,"9/11/2022 10 a.m. MDT",3679,3917,3679,0
PSCO,"9/11/2022 11 a.m. MDT",3700,4042,3637,-63
PSCO,"9/11/2022 12 p.m. MDT",3705,4125,3586,-119
PSCO,"9/11/2022 1 p.m. MDT",3789,4184,3636,-153
PSCO,"9/11/2022 2 p.m. MDT",3893,4351,3643,-250
PSCO,"9/11/2022 3 p.m. MDT",3964,4601,3729,-235
PSCO,"9/11/2022 4 p.m. MDT",4190,4832,3955,-235
PSCO,"9/11/2022 5 p.m. MDT",4471,5114,4188,-283
PSCO,"9/11/2022 6 p.m. MDT",4800,5296,4367,-433
PSCO,"9/11/2022 7 p.m. MDT",4946,5287,4513,-433
PSCO,"9/11/2022 8 p.m. MDT",4930,5394,4599,-331
PSCO,"9/11/2022 9 p.m. MDT",4805,5125,4713,-92
PSCO,"9/11/2022 10 p.m. MDT",4554,4694,4551,-3
PSCO,"9/11/2022 11 p.m. MDT",4248,4417,4230,-18
PSCO,"9/12/2022 12 a.m. MDT",4035,4119,4168,133
PSCO,"9/12/2022 1 a.m. MDT",3869,3812,4043,174
PSCO,"9/12/2022 2 a.m. MDT",3720,3677,4019,299
PSCO,"9/12/2022 3 a.m. MDT",3591,3584,3913,322
PSCO,"9/12/2022 4 a.m. MDT",3481,3554,3689,208
PSCO,"9/12/2022 5 a.m. MDT",3515,3668,3718,203
PSCO,"9/12/2022 6 a.m. MDT",3711,3838,3683,-28
PSCO,"9/12/2022 7 a.m. MDT",4049,4102,3924,-125
PSCO,"9/12/2022 8 a.m. MDT",4175,4183,4130,-45
PSCO,"9/12/2022 9 a.m. MDT",4188,4324,4229,41
PSCO,"9/12/2022 10 a.m. MDT",4249,4440,4212,-37
PSCO,"9/12/2022 11 a.m. MDT",4383,4546,4189,-194
PSCO,"9/12/2022 12 p.m. MDT",4489,4658,4183,-306
PSCO,"9/12/2022 1 p.m. MDT",4679,4834,4527,-152
PSCO,"9/12/2022 2 p.m. MDT",4919,5149,4833,-86
PSCO,"9/12/2022 3 p.m. MDT",5236,5443,5206,-30
PSCO,"9/12/2022 4 p.m. MDT",5588,5756,5571,-17
PSCO,"9/12/2022 5 p.m. MDT",5950,6162,5940,-10
PSCO,"9/12/2022 6 p.m. MDT",6233,6265,6086,-147
PSCO,"9/12/2022 7 p.m. MDT",6123,6106,6038,-85
PSCO,"9/12/2022 8 p.m. MDT",5850,5958,5777,-73
PSCO,"9/12/2022 9 p.m. MDT",5526,5683,5474,-52
PSCO,"9/12/2022 10 p.m. MDT",5111,5241,5003,-108
PSCO,"9/12/2022 11 p.m. MDT",4601,4753,4554,-47
PSCO,"9/13/2022 12 a.m. MDT",4189,4388,4247,58
PSCO,"9/13/2022 1 a.m. MDT",3954,4107,3941,-13
PSCO,"9/13/2022 2 a.m. MDT",3888,3904,3852,-36
PSCO,"9/13/2022 3 a.m. MDT",3626,3758,3625,-1
PSCO,"9/13/2022 4 a.m. MDT",3551,3648,3580,29
PSCO,"9/13/2022 5 a.m. MDT",3615,3731,3635,20
PSCO,"9/13/2022 6 a.m. MDT",3784,3882,3734,-50
PSCO,"9/13/2022 7 a.m. MDT",4147,4168,4040,-107
PSCO,"9/13/2022 8 a.m. MDT",4253,4276,4271,18
PSCO,"9/13/2022 9 a.m. MDT",4286,4401,4288,2
PSCO,"9/13/2022 10 a.m. MDT",4374,4509,4316,-58
PSCO,"9/13/2022 11 a.m. MDT",4510,4681,4452,-58
PSCO,"9/13/2022 12 p.m. MDT",4713,4852,4666,-47
PSCO,"9/13/2022 1 p.m. MDT",4851,5104,4949,98
PSCO,"9/13/2022 2 p.m. MDT",5132,5503,5170,38
PSCO,"9/13/2022 3 p.m. MDT",5495,5866,5483,-12
PSCO,"9/13/2022 4 p.m. MDT",5712,6213,5656,-56
PSCO,"9/13/2022 5 p.m. MDT",5830,6341,5763,-67
PSCO,"9/13/2022 6 p.m. MDT",5888,6389,5820,-68
PSCO,"9/13/2022 7 p.m. MDT",5780,6335,5769,-11
PSCO,"9/13/2022 8 p.m. MDT",5701,6144,5708,7
PSCO,"9/13/2022 9 p.m. MDT",5552,5849,5432,-120
PSCO,"9/13/2022 10 p.m. MDT",5218,5468,5200,-18
PSCO,"9/13/2022 11 p.m. MDT",4793,4951,4759,-34
PSCO,"9/14/2022 12 a.m. MDT",4496,4567,4355,-141
PSCO,"9/14/2022 1 a.m. MDT",4313,4179,4217,-96
PSCO,"9/14/2022 2 a.m. MDT",4157,3985,4083,-74
PSCO,"9/14/2022 3 a.m. MDT",4047,3870,4044,-3
PSCO,"9/14/2022 4 a.m. MDT",3937,3852,3881,-56
PSCO,"9/14/2022 5 a.m. MDT",3908,3872,3888,-20
PSCO,"9/14/2022 6 a.m. MDT",4095,4062,4096,1
PSCO,"9/14/2022 7 a.m. MDT",4473,4389,4244,-229
PSCO,"9/14/2022 8 a.m. MDT",4541,4542,4344,-197
PSCO,"9/14/2022 9 a.m. MDT",4590,4627,4265,-325
PSCO,"9/14/2022 10 a.m. MDT",4675,4725,4333,-342
PSCO,"9/14/2022 11 a.m. MDT",4932,4798,4526,-406
PSCO,"9/14/2022 12 p.m. MDT",5067,4988,4758,-309
PSCO,"9/14/2022 1 p.m. MDT",5209,5228,4798,-411
PSCO,"9/14/2022 2 p.m. MDT",5349,5494,4940,-409
PSCO,"9/14/2022 3 p.m. MDT",5538,5666,5125,-413
PSCO,"9/14/2022 4 p.m. MDT",5720,5777,5310,-410
PSCO,"9/14/2022 5 p.m. MDT",5665,5779,5270,-395
PSCO,"9/14/2022 6 p.m. MDT",5460,5756,5149,-311
PSCO,"9/14/2022 7 p.m. MDT",5298,5486,5014,-284
PSCO,"9/14/2022 8 p.m. MDT",5214,5539,4844,-370
PSCO,"9/14/2022 9 p.m. MDT",5093,5391,4704,-389
PSCO,"9/14/2022 10 p.m. MDT",4839,5006,4529,-310
PSCO,"9/14/2022 11 p.m. MDT",4432,4601,4219,-213
PSCO,"9/15/2022 12 a.m. MDT",4113,4235,3909,-204
PSCO,"9/15/2022 1 a.m. MDT",3882,3943,3684,-198
PSCO,"9/15/2022 2 a.m. MDT",3754,3757,3536,-218
PSCO,"9/15/2022 3 a.m. MDT",3627,3689,3570,-57
PSCO,"9/15/2022 4 a.m. MDT",3634,3655,3472,-162
PSCO,"9/15/2022 5 a.m. MDT",3695,3729,3426,-269
PSCO,"9/15/2022 6 a.m. MDT",3878,3957,3640,-238
PSCO,"9/15/2022 7 a.m. MDT",4157,4307,3924,-233
PSCO,"9/15/2022 8 a.m. MDT",4305,4427,4136,-169
PSCO,"9/15/2022 9 a.m. MDT",4428,4519,4221,-207
PSCO,"9/15/2022 10 a.m. MDT",4510,4580,4355,-155
PSCO,"9/15/2022 11 a.m. MDT",4600,4602,4414,-186
PSCO,"9/15/2022 12 p.m. MDT",4609,4712,4296,-313
PSCO,"9/15/2022 1 p.m. MDT",4735,4854,4446,-289
PSCO,"9/15/2022 2 p.m. MDT",4971,4987,4763,-208
PSCO,"9/15/2022 3 p.m. MDT",5132,5144,4939,-193
PSCO,"9/15/2022 4 p.m. MDT",5264,5278,5000,-264
PSCO,"9/15/2022 5 p.m. MDT",5457,5352,5109,-348
PSCO,"9/15/2022 6 p.m. MDT",5561,5362,5305,-256
PSCO,"9/15/2022 7 p.m. MDT",5446,5275,5111,-335
PSCO,"9/15/2022 8 p.m. MDT",5395,5268,5074,-321
PSCO,"9/15/2022 9 p.m. MDT",5220,5151,4907,-313
PSCO,"9/15/2022 10 p.m. MDT",4914,4811,4616,-298
PSCO,"9/15/2022 11 p.m. MDT",4525,4413,4301,-224
PSCO,"9/16/2022 12 a.m. MDT",4159,4101,3923,-236
PSCO,"9/16/2022 1 a.m. MDT",3893,3846,3609,-284
PSCO,"9/16/2022 2 a.m. MDT",3724,3708,3423,-301
PSCO,"9/16/2022 3 a.m. MDT",3596,3607,3318,-278
PSCO,"9/16/2022 4 a.m. MDT",3592,3560,3310,-282
PSCO,"9/16/2022 5 a.m. MDT",3646,3648,3362,-284
PSCO,"9/16/2022 6 a.m. MDT",3833,3821,3683,-150
PSCO,"9/16/2022 7 a.m. MDT",4066,4137,3913,-153
PSCO,"9/16/2022 8 a.m. MDT",4251,4194,4064,-187
PSCO,"9/16/2022 9 a.m. MDT",4239,4308,4013,-226
PSCO,"9/16/2022 10 a.m. MDT",4333,4391,4265,-68
PSCO,"9/16/2022 11 a.m. MDT",4415,4469,4329,-86
PSCO,"9/16/2022 12 p.m. MDT",4634,4568,4517,-117
PSCO,"9/16/2022 1 p.m. MDT",4831,4752,4617,-214
PSCO,"9/16/2022 2 p.m. MDT",5110,4986,4854,-256
PSCO,"9/16/2022 3 p.m. MDT",5332,5214,4948,-384
PSCO,"9/16/2022 4 p.m. MDT",5295,5443,4948,-347
PSCO,"9/16/2022 5 p.m. MDT",5326,5501,4995,-331
PSCO,"9/16/2022 6 p.m. MDT",5434,5503,5068,-366
PSCO,"9/16/2022 7 p.m. MDT",5274,5406,4935,-339
PSCO,"9/16/2022 8 p.m. MDT",5164,5325,4898,-266
PSCO,"9/16/2022 9 p.m. MDT",5018,5143,4759,-259
PSCO,"9/16/2022 10 p.m. MDT",4729,4843,4434,-295
PSCO,"9/16/2022 11 p.m. MDT",4450,4526,4132,-318
PSCO,"9/17/2022 12 a.m. MDT",4099,4249,3878,-221
PSCO,"9/17/2022 1 a.m. MDT",3852,3951,3672,-180
PSCO,"9/17/2022 2 a.m. MDT",3655,3779,3582,-73
PSCO,"9/17/2022 3 a.m. MDT",3584,3691,3513,-71
PSCO,"9/17/2022 4 a.m. MDT",3538,3674,3456,-82
PSCO,"9/17/2022 5 a.m. MDT",3508,3620,3380,-128
PSCO,"9/17/2022 6 a.m. MDT",3554,3706,3485,-69
PSCO,"9/17/2022 7 a.m. MDT",3683,3806,3511,-172
PSCO,"9/17/2022 8 a.m. MDT",3783,3801,3497,-286
PSCO,"9/17/2022 9 a.m. MDT",3816,3862,3538,-278
PSCO,"9/17/2022 10 a.m. MDT",3952,3944,3700,-252
PSCO,"9/17/2022 11 a.m. MDT",4149,4054,3646,-503
PSCO,"9/17/2022 12 p.m. MDT",4132,4153,3510,-622
PSCO,"9/17/2022 1 p.m. MDT",4326,4325,3693,-633
PSCO,"9/17/2022 2 p.m. MDT",4596,4518,4070,-526
PSCO,"9/17/2022 3 p.m. MDT",4795,4723,4323,-472
PSCO,"9/17/2022 4 p.m. MDT",4981,4995,4418,-563
PSCO,"9/17/2022 5 p.m. MDT",5212,5161,4708,-504
PSCO,"9/17/2022 6 p.m. MDT",5368,5269,4816,-552
PSCO,"9/17/2022 7 p.m. MDT",5304,5159,4862,-442
PSCO,"9/17/2022 8 p.m. MDT",5145,5197,4802,-343
PSCO,"9/17/2022 9 p.m. MDT",5065,5084,4671,-394
PSCO,"9/17/2022 10 p.m. MDT",4859,4809,4488,-371
PSCO,"9/17/2022 11 p.m. MDT",4494,4439,4202,-292
PSCO,"9/18/2022 12 a.m. MDT",4103,4142,4090,-13
PSCO,"9/18/2022 1 a.m. MDT",3854,3858,3843,-11
PSCO,"9/18/2022 2 a.m. MDT",3675,3666,3713,38
PSCO,"9/18/2022 3 a.m. MDT",3553,3567,3374,-179
PSCO,"9/18/2022 4 a.m. MDT",3475,3507,3347,-128
PSCO,"9/18/2022 5 a.m. MDT",3448,3487,3394,-54
PSCO,"9/18/2022 6 a.m. MDT",3431,3527,3312,-119
PSCO,"9/18/2022 7 a.m. MDT",3586,3615,3524,-62
PSCO,"9/18/2022 8 a.m. MDT",3687,3603,3588,-99
PSCO,"9/18/2022 9 a.m. MDT",3736,3637,3563,-173
PSCO,"9/18/2022 10 a.m. MDT",3838,3828,3413,-425
PSCO,"9/18/2022 11 a.m. MDT",3964,4062,3403,-561
PSCO,"9/18/2022 12 p.m. MDT",4090,4317,3358,-732
PSCO,"9/18/2022 1 p.m. MDT",4258,4536,3565,-693
PSCO,"9/18/2022 2 p.m. MDT",4514,4818,3984,-530
PSCO,"9/18/2022 3 p.m. MDT",4847,5212,4410,-437
PSCO,"9/18/2022 4 p.m. MDT",5241,5404,4707,-534
PSCO,"9/18/2022 5 p.m. MDT",5589,5751,5135,-454
PSCO,"9/18/2022 6 p.m. MDT",5866,6020,5358,-508
PSCO,"9/18/2022 7 p.m. MDT",5949,6064,5498,-451
PSCO,"9/18/2022 8 p.m. MDT",5821,6036,5504,-317
PSCO,"9/18/2022 9 p.m. MDT",5604,5676,5271,-333
PSCO,"9/18/2022 10 p.m. MDT",5220,5243,5000,-220
PSCO,"9/18/2022 11 p.m. MDT",4701,4805,4662,-39
PSCO,"9/19/2022 12 a.m. MDT",4236,4376,4328,92
PSCO,"9/19/2022 1 a.m. MDT",3931,4045,4062,131
PSCO,"9/19/2022 2 a.m. MDT",3754,3872,3996,242
PSCO,"9/19/2022 3 a.m. MDT",3645,3749,3865,220
PSCO,"9/19/2022 4 a.m. MDT",3622,3685,3695,73
PSCO,"9/19/2022 5 a.m. MDT",3717,3713,3640,-77
PSCO,"9/19/2022 6 a.m. MDT",3824,3879,3783,-41
PSCO,"9/19/2022 7 a.m. MDT",4132,4201,3932,-200
PSCO,"9/19/2022 8 a.m. MDT",4303,4346,3946,-357
PSCO,"9/19/2022 9 a.m. MDT",4391,4434,4131,-260
PSCO,"9/19/2022 10 a.m. MDT",4515,4639,3956,-559
PSCO,"9/19/2022 11 a.m. MDT",4735,4802,4130,-605
PSCO,"9/19/2022 12 p.m. MDT",5025,5043,4381,-644
PSCO,"9/19/2022 1 p.m. MDT",5308,5359,4728,-580
PSCO,"9/19/2022 2 p.m. MDT",5702,5730,5094,-608
PSCO,"9/19/2022 3 p.m. MDT",6091,6078,5730,-361
PSCO,"9/19/2022 4 p.m. MDT",6378,6441,5931,-447
PSCO,"9/19/2022 5 p.m. MDT",6544,6719,5940,-604
PSCO,"9/19/2022 6 p.m. MDT",6510,6833,5897,-613
PSCO,"9/19/2022 7 p.m. MDT",6378,6603,5824,-554
PSCO,"9/19/2022 8 p.m. MDT",6144,6408,5818,-326
PSCO,"9/19/2022 9 p.m. MDT",5836,6025,5531,-305
PSCO,"9/19/2022 10 p.m. MDT",5417,5574,5270,-147
PSCO,"9/19/2022 11 p.m. MDT",4901,4962,4737,-164
PSCO,"9/20/2022 12 a.m. MDT",4411,4589,4290,-121
PSCO,"9/20/2022 1 a.m. MDT",4035,4213,3853,-182
PSCO,"9/20/2022 2 a.m. MDT",3813,3999,3721,-92
PSCO,"9/20/2022 3 a.m. MDT",3696,3882,3633,-63
PSCO,"9/20/2022 4 a.m. MDT",3674,3825,3583,-91
PSCO,"9/20/2022 5 a.m. MDT",3758,3845,3717,-41
PSCO,"9/20/2022 6 a.m. MDT",3900,3994,3877,-23
PSCO,"9/20/2022 7 a.m. MDT",4237,4291,4156,-81
PSCO,"9/20/2022 8 a.m. MDT",4416,4406,4397,-19
PSCO,"9/20/2022 9 a.m. MDT",4549,4494,4360,-189
PSCO,"9/20/2022 10 a.m. MDT",4691,4674,4459,-232
PSCO,"9/20/2022 11 a.m. MDT",4886,4849,4629,-257
PSCO,"9/20/2022 12 p.m. MDT",5190,5121,4718,-472
PSCO,"9/20/2022 1 p.m. MDT",5526,5467,4967,-559
PSCO,"9/20/2022 2 p.m. MDT",5832,5846,5188,-644
PSCO,"9/20/2022 3 p.m. MDT",6193,6269,5385,-808
PSCO,"9/20/2022 4 p.m. MDT",6454,6640,5519,-935
PSCO,"9/20/2022 5 p.m. MDT",6616,6970,5737,-879
PSCO,"9/20/2022 6 p.m. MDT",6585,6811,5723,-862
PSCO,"9/20/2022 7 p.m. MDT",6392,6455,5954,-438
PSCO,"9/20/2022 8 p.m. MDT",6228,6256,6031,-197
PSCO,"9/20/2022 9 p.m. MDT",5928,5878,5950,22
PSCO,"9/20/2022 10 p.m. MDT",5542,5432,5549,7
PSCO,"9/20/2022 11 p.m. MDT",5119,4946,5052,-67
PSCO,"9/21/2022 12 a.m. MDT",4707,4576,4481,-226
PSCO,"9/21/2022 1 a.m. MDT",4345,4220,4276,-69
PSCO,"9/21/2022 2 a.m. MDT",4068,3950,4136,68
PSCO,"9/21/2022 3 a.m. MDT",3912,3812,4022,110
PSCO,"9/21/2022 4 a.m. MDT",3795,3764,3978,183
PSCO,"9/21/2022 5 a.m. MDT",3912,3824,4121,209
PSCO,"9/21/2022 6 a.m. MDT",4137,4053,4090,-47
PSCO,"9/21/2022 7 a.m. MDT",4465,4402,4288,-177
PSCO,"9/21/2022 8 a.m. MDT",4651,4559,4501,-150
PSCO,"9/21/2022 9 a.m. MDT",4698,4643,4602,-96
PSCO,"9/21/2022 10 a.m. MDT",4670,4612,4665,-5
PSCO,"9/21/2022 11 a.m. MDT",4788,4616,4722,-66
PSCO,"9/21/2022 12 p.m. MDT",4757,4638,4689,-68
PSCO,"9/21/2022 1 p.m. MDT",4679,4665,4488,-191
PSCO,"9/21/2022 2 p.m. MDT",4683,4701,4358,-325
PSCO,"9/21/2022 3 p.m. MDT",4680,4762,4249,-431
PSCO,"9/21/2022 4 p.m. MDT",4652,4796,4128,-524
PSCO,"9/21/2022 5 p.m. MDT",4682,4817,4182,-500
PSCO,"9/21/2022 6 p.m. MDT",4770,4945,4214,-556
PSCO,"9/21/2022 7 p.m. MDT",4776,4901,4152,-624
PSCO,"9/21/2022 8 p.m. MDT",4785,4936,4228,-557
PSCO,"9/21/2022 9 p.m. MDT",4584,4834,4229,-355
PSCO,"9/21/2022 10 p.m. MDT",4352,4587,3955,-397
PSCO,"9/21/2022 11 p.m. MDT",3993,4253,3658,-335
PSCO,"9/22/2022 12 a.m. MDT",3689,4009,3358,-331
PSCO,"9/22/2022 1 a.m. MDT",3566,3898,3168,-398
PSCO,"9/22/2022 2 a.m. MDT",3481,3708,3083,-398
PSCO,"9/22/2022 3 a.m. MDT",3432,3619,3067,-365
PSCO,"9/22/2022 4 a.m. MDT",3416,3610,3027,-389
PSCO,"9/22/2022 5 a.m. MDT",3485,3710,3104,-381
PSCO,"9/22/2022 6 a.m. MDT",3667,3945,3250,-417
PSCO,"9/22/2022 7 a.m. MDT",4047,4296,3738,-309
PSCO,"9/22/2022 8 a.m. MDT",4323,4412,4059,-264
PSCO,"9/22/2022 9 a.m. MDT",4436,4457,4214,-222
PSCO,"9/22/2022 10 a.m. MDT",4528,4429,4350,-178
PSCO,"9/22/2022 11 a.m. MDT",4567,4426,4360,-207
PSCO,"9/22/2022 12 p.m. MDT",4590,4443,4428,-162
PSCO,"9/22/2022 1 p.m. MDT",4553,4470,4453,-100
PSCO,"9/22/2022 2 p.m. MDT",4487,4534,4425,-62
PSCO,"9/22/2022 3 p.m. MDT",4433,4562,4362,-71
PSCO,"9/22/2022 4 p.m. MDT",4309,4627,4187,-122
PSCO,"9/22/2022 5 p.m. MDT",4543,4764,4386,-157
PSCO,"9/22/2022 6 p.m. MDT",4630,4819,4412,-218
PSCO,"9/22/2022 7 p.m. MDT",4652,4897,4477,-175
PSCO,"9/22/2022 8 p.m. MDT",4783,5027,4567,-216
PSCO,"9/22/2022 9 p.m. MDT",4679,4869,4540,-139
PSCO,"9/22/2022 10 p.m. MDT",4440,4615,4364,-76
PSCO,"9/22/2022 11 p.m. MDT",4158,4226,4122,-36
PSCO,"9/23/2022 12 a.m. MDT",3873,3979,3829,-44
PSCO,"9/23/2022 1 a.m. MDT",3705,3776,3626,-79
PSCO,"9/23/2022 2 a.m. MDT",3494,3654,3429,-65
PSCO,"9/23/2022 3 a.m. MDT",3438,3520,3353,-85
PSCO,"9/23/2022 4 a.m. MDT",3392,3498,3326,-66
PSCO,"9/23/2022 5 a.m. MDT",3538,3600,3401,-137
PSCO,"9/23/2022 6 a.m. MDT",3717,3782,3557,-160
PSCO,"9/23/2022 7 a.m. MDT",4052,4096,3813,-239
PSCO,"9/23/2022 8 a.m. MDT",4239,4188,3987,-252
PSCO,"9/23/2022 9 a.m. MDT",4250,4247,4004,-246
PSCO,"9/23/2022 10 a.m. MDT",4215,4245,3968,-247
PSCO,"9/23/2022 11 a.m. MDT",4275,4260,3979,-296
PSCO,"9/23/2022 12 p.m. MDT",4337,4283,3930,-407
PSCO,"9/23/2022 1 p.m. MDT",4423,4403,4099,-324
PSCO,"9/23/2022 2 p.m. MDT",4542,4557,4286,-256
PSCO,"9/23/2022 3 p.m. MDT",4685,4723,4367,-318
PSCO,"9/23/2022 4 p.m. MDT",4842,4949,4409,-433
PSCO,"9/23/2022 5 p.m. MDT",5023,5198,4526,-497
PSCO,"9/23/2022 6 p.m. MDT",5244,5352,4640,-604
PSCO,"9/23/2022 7 p.m. MDT",5187,5161,4565,-622
PSCO,"9/23/2022 8 p.m. MDT",5103,5107,4584,-519
PSCO,"9/23/2022 9 p.m. MDT",4890,4934,4494,-396
PSCO,"9/23/2022 10 p.m. MDT",4606,4705,4260,-346
PSCO,"9/23/2022 11 p.m. MDT",4286,4348,4082,-204
PSCO,"9/24/2022 12 a.m. MDT",3967,4049,3776,-191
PSCO,"9/24/2022 1 a.m. MDT",3670,3765,3430,-240
PSCO,"9/24/2022 2 a.m. MDT",3506,3640,3204,-302
PSCO,"9/24/2022 3 a.m. MDT",3437,3609,3104,-333
PSCO,"9/24/2022 4 a.m. MDT",3427,3569,3074,-353
PSCO,"9/24/2022 5 a.m. MDT",3510,3541,3139,-371
PSCO,"9/24/2022 6 a.m. MDT",3510,3612,3228,-282
PSCO,"9/24/2022 7 a.m. MDT",3560,3769,3324,-236
PSCO,"9/24/2022 8 a.m. MDT",3693,3832,3493,-200
PSCO,"9/24/2022 9 a.m. MDT",3797,3832,3577,-220
PSCO,"9/24/2022 10 a.m. MDT",3821,3830,3692,-129
PSCO,"9/24/2022 11 a.m. MDT",3917,3847,3860,-57
PSCO,"9/24/2022 12 p.m. MDT",4008,3929,3916,-92
PSCO,"9/24/2022 1 p.m. MDT",4092,4014,3980,-112
PSCO,"9/24/2022 2 p.m. MDT",4239,4176,4056,-183
PSCO,"9/24/2022 3 p.m. MDT",4471,4365,4280,-191
PSCO,"9/24/2022 4 p.m. MDT",4676,4613,4563,-113
PSCO,"9/24/2022 5 p.m. MDT",4960,4775,4648,-312
PSCO,"9/24/2022 6 p.m. MDT",5190,4955,4838,-352
PSCO,"9/24/2022 7 p.m. MDT",5169,4928,4849,-320
PSCO,"9/24/2022 8 p.m. MDT",5041,4976,4738,-303
PSCO,"9/24/2022 9 p.m. MDT",4804,4786,4631,-173
PSCO,"9/24/2022 10 p.m. MDT",4632,4611,4416,-216
PSCO,"9/24/2022 11 p.m. MDT",4259,4267,3995,-264
PSCO,"9/25/2022 12 a.m. MDT",3936,3982,3741,-195
PSCO,"9/25/2022 1 a.m. MDT",3745,3828,3622,-123
PSCO,"9/25/2022 2 a.m. MDT",3519,3607,3332,-187
PSCO,"9/25/2022 3 a.m. MDT",3419,3587,3231,-188
PSCO,"9/25/2022 4 a.m. MDT",3384,3509,3194,-190
PSCO,"9/25/2022 5 a.m. MDT",3406,3480,3206,-200
PSCO,"9/25/2022 6 a.m. MDT",3415,3549,3123,-292
PSCO,"9/25/2022 7 a.m. MDT",3477,3727,3142,-335
PSCO,"9/25/2022 8 a.m. MDT",3564,3735,3187,-377
PSCO,"9/25/2022 9 a.m. MDT",3614,3739,3204,-410
PSCO,"9/25/2022 10 a.m. MDT",3592,3714,3142,-450
PSCO,"9/25/2022 11 a.m. MDT",3713,3739,3245,-468
PSCO,"9/25/2022 12 p.m. MDT",3796,3844,3294,-502
PSCO,"9/25/2022 1 p.m. MDT",3890,3979,3446,-444
PSCO,"9/25/2022 2 p.m. MDT",3992,4115,3592,-400
PSCO,"9/25/2022 3 p.m. MDT",4189,4360,3715,-474
PSCO,"9/25/2022 4 p.m. MDT",4387,4452,3945,-442
PSCO,"9/25/2022 5 p.m. MDT",4646,4698,4205,-441
PSCO,"9/25/2022 6 p.m. MDT",4918,4915,4413,-505
PSCO,"9/25/2022 7 p.m. MDT",4984,5108,4459,-525
PSCO,"9/25/2022 8 p.m. MDT",4904,5144,4314,-590
PSCO,"9/25/2022 9 p.m. MDT",4711,4890,4201,-510
PSCO,"9/25/2022 10 p.m. MDT",4493,4596,4006,-487
PSCO,"9/25/2022 11 p.m. MDT",4135,4330,3679,-456
PSCO,"9/26/2022 12 a.m. MDT",3782,4000,3526,-256
PSCO,"9/26/2022 1 a.m. MDT",3587,3670,3336,-251
PSCO,"9/26/2022 2 a.m. MDT",3531,3566,3321,-210
PSCO,"9/26/2022 3 a.m. MDT",3482,3484,3434,-48
PSCO,"9/26/2022 4 a.m. MDT",3484,3461,3471,-13
PSCO,"9/26/2022 5 a.m. MDT",3548,3552,3579,31
PSCO,"9/26/2022 6 a.m. MDT",3739,3770,3713,-26
PSCO,"9/26/2022 7 a.m. MDT",4106,4110,4006,-100
PSCO,"9/26/2022 8 a.m. MDT",4238,4251,4083,-155
PSCO,"9/26/2022 9 a.m. MDT",4252,4316,4117,-135
PSCO,"9/26/2022 10 a.m. MDT",4260,4358,4116,-144
PSCO,"9/26/2022 11 a.m. MDT",4360,4405,4198,-162
PSCO,"9/26/2022 12 p.m. MDT",4432,4437,4322,-110
PSCO,"9/26/2022 1 p.m. MDT",4613,4551,4452,-161
PSCO,"9/26/2022 2 p.m. MDT",4770,4709,4630,-140
PSCO,"9/26/2022 3 p.m. MDT",4960,4947,4896,-64
PSCO,"9/26/2022 4 p.m. MDT",5211,5219,5029,-182
PSCO,"9/26/2022 5 p.m. MDT",5512,5429,5142,-370
PSCO,"9/26/2022 6 p.m. MDT",5738,5605,5279,-459
PSCO,"9/26/2022 7 p.m. MDT",5678,5457,5274,-404
PSCO,"9/26/2022 8 p.m. MDT",5501,5396,5299,-202
PSCO,"9/26/2022 9 p.m. MDT",5190,5148,5193,3
PSCO,"9/26/2022 10 p.m. MDT",4823,4814,4812,-11
PSCO,"9/26/2022 11 p.m. MDT",4392,4392,4361,-31
PSCO,"9/27/2022 12 a.m. MDT",4000,4062,3744,-256
PSCO,"9/27/2022 1 a.m. MDT",3781,3885,3519,-262
PSCO,"9/27/2022 2 a.m. MDT",3613,3698,3542,-71
PSCO,"9/27/2022 3 a.m. MDT",3471,3592,3408,-63
PSCO,"9/27/2022 4 a.m. MDT",3426,3556,3379,-47
PSCO,"9/27/2022 5 a.m. MDT",3504,3628,3439,-65
PSCO,"9/27/2022 6 a.m. MDT",3783,3834,3687,-96
PSCO,"9/27/2022 7 a.m. MDT",4145,4164,3997,-148
PSCO,"9/27/2022 8 a.m. MDT",4303,4310,4214,-89
PSCO,"9/27/2022 9 a.m. MDT",4324,4355,4260,-64
PSCO,"9/27/2022 10 a.m. MDT",4340,4379,4268,-72
PSCO,"9/27/2022 11 a.m. MDT",4402,4448,4295,-107
PSCO,"9/27/2022 12 p.m. MDT",4525,4516,4345,-180
PSCO,"9/27/2022 1 p.m. MDT",4710,4716,4515,-195
PSCO,"9/27/2022 2 p.m. MDT",4897,4875,4658,-239
PSCO,"9/27/2022 3 p.m. MDT",4955,5073,4774,-181
PSCO,"9/27/2022 4 p.m. MDT",4984,5225,4922,-62
PSCO,"9/27/2022 5 p.m. MDT",5067,5444,5025,-42
PSCO,"9/27/2022 6 p.m. MDT",5112,5431,5120,8
PSCO,"9/27/2022 7 p.m. MDT",5139,5369,5149,10
PSCO,"9/27/2022 8 p.m. MDT",5199,5387,5249,50
PSCO,"9/27/2022 9 p.m. MDT",5004,5157,5076,72
PSCO,"9/27/2022 10 p.m. MDT",4732,4835,4755,23
PSCO,"9/27/2022 11 p.m. MDT",4393,4479,4456,63
PSCO,"9/28/2022 12 a.m. MDT",4069,4122,3922,-147
PSCO,"9/28/2022 1 a.m. MDT",3795,3822,3658,-137
PSCO,"9/28/2022 2 a.m. MDT",3728,3703,3824,96
PSCO,"9/28/2022 3 a.m. MDT",3636,3621,3761,125
PSCO,"9/28/2022 4 a.m. MDT",3631,3597,3830,199
PSCO,"9/28/2022 5 a.m. MDT",3714,3646,3839,125
PSCO,"9/28/2022 6 a.m. MDT",3904,3859,3947,43
PSCO,"9/28/2022 7 a.m. MDT",4278,4189,4287,9
PSCO,"9/28/2022 8 a.m. MDT",4406,4314,4346,-60
PSCO,"9/28/2022 9 a.m. MDT",4329,4380,4184,-145
PSCO,"9/28/2022 10 a.m. MDT",4366,4371,4252,-114
PSCO,"9/28/2022 11 a.m. MDT",4464,4396,4376,-88
PSCO,"9/28/2022 12 p.m. MDT",4640,4518,4464,-176
PSCO,"9/28/2022 1 p.m. MDT",4856,4654,4698,-158
PSCO,"9/28/2022 2 p.m. MDT",5036,4840,4904,-132
PSCO,"9/28/2022 3 p.m. MDT",5253,5057,5067,-186
PSCO,"9/28/2022 4 p.m. MDT",5455,5295,5367,-88
PSCO,"9/28/2022 5 p.m. MDT",5605,5555,5630,25
PSCO,"9/28/2022 6 p.m. MDT",5754,5605,5699,-55
PSCO,"9/28/2022 7 p.m. MDT",5643,5545,5567,-76
PSCO,"9/28/2022 8 p.m. MDT",5522,5510,5426,-96
PSCO,"9/28/2022 9 p.m. MDT",5303,5271,5282,-21
PSCO,"9/28/2022 10 p.m. MDT",4943,4936,4951,8
PSCO,"9/28/2022 11 p.m. MDT",4578,4524,4493,-85
PSCO,"9/29/2022 12 a.m. MDT",4268,4190,4352,84
PSCO,"9/29/2022 1 a.m. MDT",4007,3940,4075,68
PSCO,"9/29/2022 2 a.m. MDT",3841,3781,4044,203
PSCO,"9/29/2022 3 a.m. MDT",3702,3651,3990,288
PSCO,"9/29/2022 4 a.m. MDT",3724,3606,3945,221
PSCO,"9/29/2022 5 a.m. MDT",3716,3646,3850,134
PSCO,"9/29/2022 6 a.m. MDT",3927,3866,4064,137
PSCO,"9/29/2022 7 a.m. MDT",4220,4192,4377,157
PSCO,"9/29/2022 8 a.m. MDT",4357,4298,4374,17
PSCO,"9/29/2022 9 a.m. MDT",4463,4382,4228,-235
PSCO,"9/29/2022 10 a.m. MDT",4507,4409,4130,-377
PSCO,"9/29/2022 11 a.m. MDT",4682,4522,4245,-437
PSCO,"9/29/2022 12 p.m. MDT",4838,4662,4505,-333
PSCO,"9/29/2022 1 p.m. MDT",5070,4781,4707,-363
PSCO,"9/29/2022 2 p.m. MDT",5281,5042,5065,-216
PSCO,"9/29/2022 3 p.m. MDT",5290,5302,4805,-485
PSCO,"9/29/2022 4 p.m. MDT",5420,5509,4976,-444
PSCO,"9/29/2022 5 p.m. MDT",5588,5603,5057,-531
PSCO,"9/29/2022 6 p.m. MDT",5582,5591,5256,-326
PSCO,"9/29/2022 7 p.m. MDT",5492,5418,5208,-284
PSCO,"9/29/2022 8 p.m. MDT",5461,5455,5289,-172
PSCO,"9/29/2022 9 p.m. MDT",5286,5226,5179,-107
PSCO,"9/29/2022 10 p.m. MDT",5025,4890,4993,-32
PSCO,"9/29/2022 11 p.m. MDT",4569,4504,4538,-31
PSCO,"9/30/2022 12 a.m. MDT",4162,4152,4251,89
PSCO,"9/30/2022 1 a.m. MDT",3860,3931,3800,-60
PSCO,"9/30/2022 2 a.m. MDT",3679,3756,3628,-51
PSCO,"9/30/2022 3 a.m. MDT",3585,3590,3469,-116
PSCO,"9/30/2022 4 a.m. MDT",3542,3568,3395,-147
PSCO,"9/30/2022 5 a.m. MDT",3630,3619,3528,-102
PSCO,"9/30/2022 6 a.m. MDT",3811,3839,3698,-113
PSCO,"9/30/2022 7 a.m. MDT",4123,4172,3966,-157
PSCO,"9/30/2022 8 a.m. MDT",4309,4286,4177,-132
PSCO,"9/30/2022 9 a.m. MDT",4369,4355,4075,-294
PSCO,"9/30/2022 10 a.m. MDT",4424,4345,4069,-355
PSCO,"9/30/2022 11 a.m. MDT",4560,4452,4040,-520
PSCO,"9/30/2022 12 p.m. MDT",4685,4544,4194,-491
PSCO,"9/30/2022 1 p.m. MDT",4896,4718,4258,-638
PSCO,"9/30/2022 2 p.m. MDT",5011,4922,4400,-611
PSCO,"9/30/2022 3 p.m. MDT",5151,5112,4461,-690
PSCO,"9/30/2022 4 p.m. MDT",5290,5156,4609,-681
PSCO,"9/30/2022 5 p.m. MDT",5169,5216,4698,-471
PSCO,"9/30/2022 6 p.m. MDT",5029,5150,4660,-369
PSCO,"9/30/2022 7 p.m. MDT",4896,5053,4763,-133
PSCO,"9/30/2022 8 p.m. MDT",4917,5044,4775,-142
PSCO,"9/30/2022 9 p.m. MDT",4774,4791,4657,-117
PSCO,"9/30/2022 10 p.m. MDT",4579,4514,4578,-1
PSCO,"9/30/2022 11 p.m. MDT",4260,4220,4282,22
PSCO,"10/1/2022 12 a.m. MDT",3981,3999,4072,91
